date,income,expenditure,balance,comment
08/Sep/1979,,5.0,-5.0,sowing costs
08/Sep/1979,,15.0,-20.0,sowing costs
08/Sep/1979,,0.25,-20.25,operating costs of operator1 + presow_till
09/Sep/1979,,0.25,-20.5,operating costs of operator1 + sowing
10/Sep/1979,,0.75,-21.25,operating costs of operator1 + presow_till
11/Sep/1979,,0.75,-22.0,operating costs of operator1 + sowing
08/Oct/1979,,0.25,-22.25,operating costs of operator1 + weeding
09/Oct/1979,,0.75,-23.0,operating costs of operator1 + weeding
21/Dec/1979,0.0,,-23.0,cropprice (maize)
21/Dec/1979,15.312185113636366,,-7.687814886363634,cropprice (maize_residue)
21/Dec/1979,0.0,,-7.687814886363634,cropprice (maize)
21/Dec/1979,45.936555340909095,,38.24874045454546,cropprice (maize_residue)
21/Dec/1979,,0.25,37.99874045454546,operating costs of operator1 + harvesting
22/Dec/1979,,0.75,37.24874045454546,operating costs of operator1 + harvesting
30/Jan/1980,,0.25,36.99874045454546,operating costs of operator1 + weeding
31/Jan/1980,,0.75,36.24874045454546,operating costs of operator1 + weeding
08/Apr/1980,,10.5,25.748740454545462,sowing costs
08/Apr/1980,,31.5,-5.751259545454538,sowing costs
08/Apr/1980,,0.25,-6.001259545454538,operating costs of operator1 + presow_till
09/Apr/1980,,0.25,-6.251259545454538,operating costs of operator1 + sowing
10/Apr/1980,,0.75,-7.001259545454538,operating costs of operator1 + presow_till
11/Apr/1980,,0.75,-7.751259545454538,operating costs of operator1 + sowing
08/May/1980,,0.25,-8.001259545454538,operating costs of operator1 + weeding
09/May/1980,,0.75,-8.751259545454538,operating costs of operator1 + weeding
29/Jun/1980,,606.1,-614.8512595454546,Farm Overheads
18/Jul/1980,720.0996321988637,,105.24837265340909,cropprice (maize)
18/Jul/1980,45.80374977272727,,151.05212242613635,cropprice (maize_residue)
18/Jul/1980,,0.75,150.30212242613635,operating costs of operator1 + harvesting
29/Jul/1980,796.0888699431817,,946.3909923693182,cropprice (bean)
29/Jul/1980,0.0,,946.3909923693182,cropprice (maize)
29/Jul/1980,58.31491366477274,,1004.7059060340908,cropprice (maize_residue)
29/Jul/1980,,0.25,1004.4559060340908,operating costs of operator1 + harvesting
30/Jul/1980,,0.25,1004.2059060340908,operating costs of operator1 + harvesting
27/Aug/1980,,0.75,1003.4559060340908,operating costs of operator1 + weeding
31/Aug/1980,,5.0,998.4559060340908,sowing costs
31/Aug/1980,,15.0,983.4559060340908,sowing costs
31/Aug/1980,,0.25,983.2059060340908,operating costs of operator1 + presow_till
01/Sep/1980,,0.25,982.9559060340908,operating costs of operator1 + sowing
02/Sep/1980,,0.75,982.2059060340908,operating costs of operator1 + presow_till
03/Sep/1980,,0.75,981.4559060340908,operating costs of operator1 + sowing
07/Sep/1980,,0.25,981.2059060340908,operating costs of operator1 + weeding
30/Sep/1980,,0.25,980.9559060340908,operating costs of operator1 + weeding
01/Oct/1980,,0.75,980.2059060340908,operating costs of operator1 + weeding
09/Dec/1980,243.49032064772726,,1223.6962266818182,cropprice (maize)
09/Dec/1980,17.577498,,1241.2737246818183,cropprice (maize_residue)
09/Dec/1980,,0.25,1241.0237246818183,operating costs of operator1 + harvesting
21/Dec/1980,0.0,,1241.0237246818183,cropprice (maize)
21/Dec/1980,45.28657670454545,,1286.3103013863638,cropprice (maize_residue)
21/Dec/1980,,0.75,1285.5603013863638,operating costs of operator1 + harvesting
18/Jan/1981,,0.25,1285.3103013863638,operating costs of operator1 + weeding
30/Jan/1981,,0.75,1284.5603013863638,operating costs of operator1 + weeding
15/Mar/1981,,10.5,1274.0603013863638,sowing costs
15/Mar/1981,,31.5,1242.5603013863638,sowing costs
15/Mar/1981,,0.25,1242.3103013863638,operating costs of operator1 + presow_till
16/Mar/1981,,0.25,1242.0603013863638,operating costs of operator1 + sowing
17/Mar/1981,,0.75,1241.3103013863638,operating costs of operator1 + presow_till
18/Mar/1981,,0.75,1240.5603013863638,operating costs of operator1 + sowing
14/Apr/1981,,0.25,1240.3103013863638,operating costs of operator1 + weeding
15/Apr/1981,,0.75,1239.5603013863638,operating costs of operator1 + weeding
25/Jun/1981,394.1691283806818,,1633.7294297670455,cropprice (bean)
25/Jun/1981,278.7196039772727,,1912.4490337443183,cropprice (maize)
25/Jun/1981,48.22360506818182,,1960.6726388125,cropprice (maize_residue)
25/Jun/1981,,0.25,1960.4226388125,operating costs of operator1 + harvesting
26/Jun/1981,,0.25,1960.1726388125,operating costs of operator1 + harvesting
30/Jun/1981,,606.1,1354.0726388125,Farm Overheads
06/Jul/1981,0.0,,1354.0726388125,cropprice (maize)
06/Jul/1981,42.926584414772734,,1396.9992232272728,cropprice (maize_residue)
06/Jul/1981,,0.75,1396.2492232272728,operating costs of operator1 + harvesting
04/Aug/1981,,0.25,1395.9992232272728,operating costs of operator1 + weeding
15/Aug/1981,,0.75,1395.2492232272728,operating costs of operator1 + weeding
01/Sep/1981,,5.0,1390.2492232272728,sowing costs
01/Sep/1981,,15.0,1375.2492232272728,sowing costs
01/Sep/1981,,0.25,1374.9992232272728,operating costs of operator1 + presow_till
02/Sep/1981,,0.25,1374.7492232272728,operating costs of operator1 + sowing
03/Sep/1981,,0.75,1373.9992232272728,operating costs of operator1 + presow_till
04/Sep/1981,,0.75,1373.2492232272728,operating costs of operator1 + sowing
01/Oct/1981,,0.25,1372.9992232272728,operating costs of operator1 + weeding
02/Oct/1981,,0.75,1372.2492232272728,operating costs of operator1 + weeding
11/Dec/1981,330.8842869332387,,1703.1335101605114,cropprice (maize)
11/Dec/1981,27.061845261363636,,1730.195355421875,cropprice (maize_residue)
11/Dec/1981,,0.25,1729.945355421875,operating costs of operator1 + harvesting
27/Dec/1981,0.0,,1729.945355421875,cropprice (maize)
27/Dec/1981,37.65949735227273,,1767.6048527741477,cropprice (maize_residue)
27/Dec/1981,,0.75,1766.8548527741477,operating costs of operator1 + harvesting
20/Jan/1982,,0.25,1766.6048527741477,operating costs of operator1 + weeding
05/Feb/1982,,0.75,1765.8548527741477,operating costs of operator1 + weeding
23/Mar/1982,,10.5,1755.3548527741477,sowing costs
23/Mar/1982,,31.5,1723.8548527741477,sowing costs
23/Mar/1982,,0.25,1723.6048527741477,operating costs of operator1 + presow_till
24/Mar/1982,,0.25,1723.3548527741477,operating costs of operator1 + sowing
25/Mar/1982,,0.75,1722.6048527741477,operating costs of operator1 + presow_till
26/Mar/1982,,0.75,1721.8548527741477,operating costs of operator1 + sowing
22/Apr/1982,,0.25,1721.6048527741477,operating costs of operator1 + weeding
23/Apr/1982,,0.75,1720.8548527741477,operating costs of operator1 + weeding
30/Jun/1982,,606.1,1114.7548527741478,Farm Overheads
01/Jul/1982,151.4100972443182,,1266.164950018466,cropprice (bean)
01/Jul/1982,350.0496734318182,,1616.2146234502843,cropprice (maize)
01/Jul/1982,41.528317539772736,,1657.7429409900571,cropprice (maize_residue)
01/Jul/1982,659.3726501974431,,2317.1155911875003,cropprice (maize)
01/Jul/1982,42.79992121022727,,2359.9155123977275,cropprice (maize_residue)
01/Jul/1982,,0.25,2359.6655123977275,operating costs of operator1 + harvesting
02/Jul/1982,,0.25,2359.4155123977275,operating costs of operator1 + harvesting
03/Jul/1982,,0.75,2358.6655123977275,operating costs of operator1 + harvesting
10/Aug/1982,,0.25,2358.4155123977275,operating costs of operator1 + weeding
11/Aug/1982,,0.75,2357.6655123977275,operating costs of operator1 + weeding
08/Sep/1982,,5.0,2352.6655123977275,sowing costs
08/Sep/1982,,15.0,2337.6655123977275,sowing costs
08/Sep/1982,,0.25,2337.4155123977275,operating costs of operator1 + presow_till
09/Sep/1982,,0.25,2337.1655123977275,operating costs of operator1 + sowing
10/Sep/1982,,0.75,2336.4155123977275,operating costs of operator1 + presow_till
11/Sep/1982,,0.75,2335.6655123977275,operating costs of operator1 + sowing
08/Oct/1982,,0.25,2335.4155123977275,operating costs of operator1 + weeding
09/Oct/1982,,0.75,2334.6655123977275,operating costs of operator1 + weeding
20/Dec/1982,261.5612699019887,,2596.2267822997164,cropprice (maize)
20/Dec/1982,20.20943659090909,,2616.4362188906257,cropprice (maize_residue)
20/Dec/1982,,0.25,2616.1862188906257,operating costs of operator1 + harvesting
24/Dec/1982,0.0,,2616.1862188906257,cropprice (maize)
24/Dec/1982,60.247616846590915,,2676.4338357372167,cropprice (maize_residue)
24/Dec/1982,,0.75,2675.6838357372167,operating costs of operator1 + harvesting
29/Jan/1983,,0.25,2675.4338357372167,operating costs of operator1 + weeding
02/Feb/1983,,0.75,2674.6838357372167,operating costs of operator1 + weeding
16/Mar/1983,,10.5,2664.1838357372167,sowing costs
16/Mar/1983,,31.5,2632.6838357372167,sowing costs
16/Mar/1983,,0.25,2632.4338357372167,operating costs of operator1 + presow_till
17/Mar/1983,,0.25,2632.1838357372167,operating costs of operator1 + sowing
18/Mar/1983,,0.75,2631.4338357372167,operating costs of operator1 + presow_till
19/Mar/1983,,0.75,2630.6838357372167,operating costs of operator1 + sowing
15/Apr/1983,,0.25,2630.4338357372167,operating costs of operator1 + weeding
16/Apr/1983,,0.75,2629.6838357372167,operating costs of operator1 + weeding
18/Jun/1983,106.58888207386363,,2736.2727178110804,cropprice (bean)
18/Jun/1983,297.7071223806818,,3033.9798401917624,cropprice (maize)
18/Jun/1983,34.69860839772728,,3068.6784485894896,cropprice (maize_residue)
18/Jun/1983,,0.25,3068.4284485894896,operating costs of operator1 + harvesting
19/Jun/1983,,0.25,3068.1784485894896,operating costs of operator1 + harvesting
26/Jun/1983,0.0,,3068.1784485894896,cropprice (maize)
26/Jun/1983,45.70875964772728,,3113.887208237217,cropprice (maize_residue)
26/Jun/1983,,0.75,3113.137208237217,operating costs of operator1 + harvesting
30/Jun/1983,,606.1,2507.037208237217,Farm Overheads
28/Jul/1983,,0.25,2506.787208237217,operating costs of operator1 + weeding
05/Aug/1983,,0.75,2506.037208237217,operating costs of operator1 + weeding
01/Sep/1983,,5.0,2501.037208237217,sowing costs
01/Sep/1983,,15.0,2486.037208237217,sowing costs
01/Sep/1983,,0.25,2485.787208237217,operating costs of operator1 + presow_till
02/Sep/1983,,0.25,2485.537208237217,operating costs of operator1 + sowing
03/Sep/1983,,0.75,2484.787208237217,operating costs of operator1 + presow_till
04/Sep/1983,,0.75,2484.037208237217,operating costs of operator1 + sowing
01/Oct/1983,,0.25,2483.787208237217,operating costs of operator1 + weeding
02/Oct/1983,,0.75,2483.037208237217,operating costs of operator1 + weeding
12/Dec/1983,231.97317010227275,,2715.0103783394898,cropprice (maize)
12/Dec/1983,17.10310780113636,,2732.1134861406263,cropprice (maize_residue)
12/Dec/1983,,0.25,2731.8634861406263,operating costs of operator1 + harvesting
28/Dec/1983,0.0,,2731.8634861406263,cropprice (maize)
28/Dec/1983,37.234601113636366,,2769.0980872542627,cropprice (maize_residue)
28/Dec/1983,,0.75,2768.3480872542627,operating costs of operator1 + harvesting
21/Jan/1984,,0.25,2768.0980872542627,operating costs of operator1 + weeding
06/Feb/1984,,0.75,2767.3480872542627,operating costs of operator1 + weeding
14/Mar/1984,,10.5,2756.8480872542627,sowing costs
14/Mar/1984,,31.5,2725.3480872542627,sowing costs
14/Mar/1984,,0.25,2725.0980872542627,operating costs of operator1 + presow_till
15/Mar/1984,,0.25,2724.8480872542627,operating costs of operator1 + sowing
16/Mar/1984,,0.75,2724.0980872542627,operating costs of operator1 + presow_till
17/Mar/1984,,0.75,2723.3480872542627,operating costs of operator1 + sowing
13/Apr/1984,,0.25,2723.0980872542627,operating costs of operator1 + weeding
14/Apr/1984,,0.75,2722.3480872542627,operating costs of operator1 + weeding
18/Jun/1984,91.98911841477272,,2814.3372056690355,cropprice (bean)
18/Jun/1984,328.33973940767044,,3142.676945076706,cropprice (maize)
18/Jun/1984,31.70786909659091,,3174.384814173297,cropprice (maize_residue)
18/Jun/1984,,0.25,3174.134814173297,operating costs of operator1 + harvesting
19/Jun/1984,,0.25,3173.884814173297,operating costs of operator1 + harvesting
20/Jun/1984,390.3268856676136,,3564.2116998409106,cropprice (maize)
20/Jun/1984,47.62554932386364,,3611.837249164774,cropprice (maize_residue)
20/Jun/1984,,0.75,3611.087249164774,operating costs of operator1 + harvesting
29/Jun/1984,,606.1,3004.9872491647743,Farm Overheads
28/Jul/1984,,0.25,3004.7372491647743,operating costs of operator1 + weeding
30/Jul/1984,,0.75,3003.9872491647743,operating costs of operator1 + weeding
30/Aug/1984,,5.0,2998.9872491647743,sowing costs
30/Aug/1984,,15.0,2983.9872491647743,sowing costs
30/Aug/1984,,0.25,2983.7372491647743,operating costs of operator1 + presow_till
31/Aug/1984,,0.25,2983.4872491647743,operating costs of operator1 + sowing
01/Sep/1984,,0.75,2982.7372491647743,operating costs of operator1 + presow_till
02/Sep/1984,,0.75,2981.9872491647743,operating costs of operator1 + sowing
29/Sep/1984,,0.25,2981.7372491647743,operating costs of operator1 + weeding
30/Sep/1984,,0.75,2980.9872491647743,operating costs of operator1 + weeding
09/Dec/1984,174.49111583948869,,3155.478365004263,cropprice (maize)
09/Dec/1984,16.006183971590907,,3171.484548975854,cropprice (maize_residue)
09/Dec/1984,,0.25,3171.234548975854,operating costs of operator1 + harvesting
10/Dec/1984,226.78556293892046,,3398.0201119147746,cropprice (maize)
10/Dec/1984,56.67443848295455,,3454.694550397729,cropprice (maize_residue)
10/Dec/1984,,0.75,3453.944550397729,operating costs of operator1 + harvesting
18/Jan/1985,,0.25,3453.694550397729,operating costs of operator1 + weeding
19/Jan/1985,,0.75,3452.944550397729,operating costs of operator1 + weeding
20/Mar/1985,,10.5,3442.444550397729,sowing costs
20/Mar/1985,,31.5,3410.944550397729,sowing costs
20/Mar/1985,,0.25,3410.694550397729,operating costs of operator1 + presow_till
21/Mar/1985,,0.25,3410.444550397729,operating costs of operator1 + sowing
22/Mar/1985,,0.75,3409.694550397729,operating costs of operator1 + presow_till
23/Mar/1985,,0.75,3408.944550397729,operating costs of operator1 + sowing
19/Apr/1985,,0.25,3408.694550397729,operating costs of operator1 + weeding
20/Apr/1985,,0.75,3407.944550397729,operating costs of operator1 + weeding
30/Jun/1985,,606.1,2801.844550397729,Farm Overheads
05/Jul/1985,737.9128084602273,,3539.757358857956,cropprice (bean)
05/Jul/1985,0.0,,3539.757358857956,cropprice (maize)
05/Jul/1985,63.954090465909076,,3603.711449323865,cropprice (maize_residue)
05/Jul/1985,0.0,,3603.711449323865,cropprice (maize)
05/Jul/1985,57.27318502840909,,3660.984634352274,cropprice (maize_residue)
05/Jul/1985,,0.25,3660.734634352274,operating costs of operator1 + harvesting
06/Jul/1985,,0.25,3660.484634352274,operating costs of operator1 + harvesting
07/Jul/1985,,0.75,3659.734634352274,operating costs of operator1 + harvesting
14/Aug/1985,,0.25,3659.484634352274,operating costs of operator1 + weeding
15/Aug/1985,,0.75,3658.734634352274,operating costs of operator1 + weeding
01/Sep/1985,,5.0,3653.734634352274,sowing costs
01/Sep/1985,,15.0,3638.734634352274,sowing costs
01/Sep/1985,,0.25,3638.484634352274,operating costs of operator1 + presow_till
02/Sep/1985,,0.25,3638.234634352274,operating costs of operator1 + sowing
03/Sep/1985,,0.75,3637.484634352274,operating costs of operator1 + presow_till
04/Sep/1985,,0.75,3636.734634352274,operating costs of operator1 + sowing
01/Oct/1985,,0.25,3636.484634352274,operating costs of operator1 + weeding
02/Oct/1985,,0.75,3635.734634352274,operating costs of operator1 + weeding
13/Dec/1985,11.920113988636363,,3647.6547483409104,cropprice (maize)
13/Dec/1985,20.306404806818183,,3667.9611531477285,cropprice (maize_residue)
13/Dec/1985,,0.25,3667.7111531477285,operating costs of operator1 + harvesting
29/Dec/1985,0.0,,3667.7111531477285,cropprice (maize)
29/Dec/1985,19.347323335227276,,3687.058476482956,cropprice (maize_residue)
29/Dec/1985,,0.75,3686.308476482956,operating costs of operator1 + harvesting
22/Jan/1986,,0.25,3686.058476482956,operating costs of operator1 + weeding
07/Feb/1986,,0.75,3685.308476482956,operating costs of operator1 + weeding
21/Mar/1986,,10.5,3674.808476482956,sowing costs
21/Mar/1986,,31.5,3643.308476482956,sowing costs
21/Mar/1986,,0.25,3643.058476482956,operating costs of operator1 + presow_till
22/Mar/1986,,0.25,3642.808476482956,operating costs of operator1 + sowing
23/Mar/1986,,0.75,3642.058476482956,operating costs of operator1 + presow_till
24/Mar/1986,,0.75,3641.308476482956,operating costs of operator1 + sowing
20/Apr/1986,,0.25,3641.058476482956,operating costs of operator1 + weeding
21/Apr/1986,,0.75,3640.308476482956,operating costs of operator1 + weeding
30/Jun/1986,,606.1,3034.208476482956,Farm Overheads
01/Jul/1986,317.4002006079546,,3351.6086770909105,cropprice (bean)
01/Jul/1986,267.33674138352274,,3618.945418474433,cropprice (maize)
01/Jul/1986,44.17012994886364,,3663.115548423297,cropprice (maize_residue)
01/Jul/1986,,0.25,3662.865548423297,operating costs of operator1 + harvesting
02/Jul/1986,331.21117521306815,,3994.076723636365,cropprice (maize)
02/Jul/1986,53.603809704545455,,4047.68053334091,cropprice (maize_residue)
02/Jul/1986,,0.25,4047.43053334091,operating costs of operator1 + harvesting
03/Jul/1986,,0.75,4046.68053334091,operating costs of operator1 + harvesting
10/Aug/1986,,0.25,4046.43053334091,operating costs of operator1 + weeding
11/Aug/1986,,0.75,4045.68053334091,operating costs of operator1 + weeding
02/Sep/1986,,5.0,4040.68053334091,sowing costs
02/Sep/1986,,15.0,4025.68053334091,sowing costs
02/Sep/1986,,0.25,4025.43053334091,operating costs of operator1 + presow_till
03/Sep/1986,,0.25,4025.18053334091,operating costs of operator1 + sowing
04/Sep/1986,,0.75,4024.43053334091,operating costs of operator1 + presow_till
05/Sep/1986,,0.75,4023.68053334091,operating costs of operator1 + sowing
02/Oct/1986,,0.25,4023.43053334091,operating costs of operator1 + weeding
03/Oct/1986,,0.75,4022.68053334091,operating costs of operator1 + weeding
11/Dec/1986,344.56178128125,,4367.24231462216,cropprice (maize)
11/Dec/1986,27.225352892045454,,4394.4676675142055,cropprice (maize_residue)
11/Dec/1986,,0.25,4394.2176675142055,operating costs of operator1 + harvesting
18/Dec/1986,0.0,,4394.2176675142055,cropprice (maize)
18/Dec/1986,53.79714410795454,,4448.01481162216,cropprice (maize_residue)
18/Dec/1986,,0.75,4447.26481162216,operating costs of operator1 + harvesting
20/Jan/1987,,0.25,4447.01481162216,operating costs of operator1 + weeding
27/Jan/1987,,0.75,4446.26481162216,operating costs of operator1 + weeding
16/Mar/1987,,10.5,4435.76481162216,sowing costs
16/Mar/1987,,31.5,4404.26481162216,sowing costs
16/Mar/1987,,0.25,4404.01481162216,operating costs of operator1 + presow_till
17/Mar/1987,,0.25,4403.76481162216,operating costs of operator1 + sowing
18/Mar/1987,,0.75,4403.01481162216,operating costs of operator1 + presow_till
19/Mar/1987,,0.75,4402.26481162216,operating costs of operator1 + sowing
15/Apr/1987,,0.25,4402.01481162216,operating costs of operator1 + weeding
16/Apr/1987,,0.75,4401.26481162216,operating costs of operator1 + weeding
22/Jun/1987,223.04927543181822,,4624.314087053978,cropprice (bean)
22/Jun/1987,265.2626641661932,,4889.576751220171,cropprice (maize)
22/Jun/1987,42.08554631818182,,4931.6622975383525,cropprice (maize_residue)
22/Jun/1987,,0.25,4931.4122975383525,operating costs of operator1 + harvesting
23/Jun/1987,,0.25,4931.1622975383525,operating costs of operator1 + harvesting
30/Jun/1987,,606.1,4325.062297538352,Farm Overheads
06/Jul/1987,0.0,,4325.062297538352,cropprice (maize)
06/Jul/1987,43.49019553977272,,4368.552493078125,cropprice (maize_residue)
06/Jul/1987,,0.75,4367.802493078125,operating costs of operator1 + harvesting
01/Aug/1987,,0.25,4367.552493078125,operating costs of operator1 + weeding
15/Aug/1987,,0.75,4366.802493078125,operating costs of operator1 + weeding
09/Sep/1987,,5.0,4361.802493078125,sowing costs
09/Sep/1987,,15.0,4346.802493078125,sowing costs
09/Sep/1987,,0.25,4346.552493078125,operating costs of operator1 + presow_till
10/Sep/1987,,0.25,4346.302493078125,operating costs of operator1 + sowing
11/Sep/1987,,0.75,4345.552493078125,operating costs of operator1 + presow_till
12/Sep/1987,,0.75,4344.802493078125,operating costs of operator1 + sowing
09/Oct/1987,,0.25,4344.552493078125,operating costs of operator1 + weeding
10/Oct/1987,,0.75,4343.802493078125,operating costs of operator1 + weeding
17/Dec/1987,359.2749569659091,,4703.077450044034,cropprice (maize)
17/Dec/1987,32.59662697727273,,4735.674077021306,cropprice (maize_residue)
17/Dec/1987,,0.25,4735.424077021306,operating costs of operator1 + harvesting
30/Dec/1987,0.0,,4735.424077021306,cropprice (maize)
30/Dec/1987,43.16954456249999,,4778.593621583806,cropprice (maize_residue)
30/Dec/1987,,0.75,4777.843621583806,operating costs of operator1 + harvesting
26/Jan/1988,,0.25,4777.593621583806,operating costs of operator1 + weeding
08/Feb/1988,,0.75,4776.843621583806,operating costs of operator1 + weeding
17/Mar/1988,,10.5,4766.343621583806,sowing costs
17/Mar/1988,,31.5,4734.843621583806,sowing costs
17/Mar/1988,,0.25,4734.593621583806,operating costs of operator1 + presow_till
18/Mar/1988,,0.25,4734.343621583806,operating costs of operator1 + sowing
19/Mar/1988,,0.75,4733.593621583806,operating costs of operator1 + presow_till
20/Mar/1988,,0.75,4732.843621583806,operating costs of operator1 + sowing
16/Apr/1988,,0.25,4732.593621583806,operating costs of operator1 + weeding
17/Apr/1988,,0.75,4731.843621583806,operating costs of operator1 + weeding
26/Jun/1988,583.4035699943182,,5315.247191578124,cropprice (bean)
26/Jun/1988,128.0661500625,,5443.3133416406245,cropprice (maize)
26/Jun/1988,68.6555619659091,,5511.968903606534,cropprice (maize_residue)
26/Jun/1988,,0.25,5511.718903606534,operating costs of operator1 + harvesting
27/Jun/1988,,0.25,5511.468903606534,operating costs of operator1 + harvesting
29/Jun/1988,,606.1,4905.368903606533,Farm Overheads
08/Jul/1988,0.0,,4905.368903606533,cropprice (maize)
08/Jul/1988,44.460246698863635,,4949.829150305397,cropprice (maize_residue)
08/Jul/1988,,0.75,4949.079150305397,operating costs of operator1 + harvesting
05/Aug/1988,,0.25,4948.829150305397,operating costs of operator1 + weeding
17/Aug/1988,,0.75,4948.079150305397,operating costs of operator1 + weeding
30/Aug/1988,,5.0,4943.079150305397,sowing costs
30/Aug/1988,,15.0,4928.079150305397,sowing costs
30/Aug/1988,,0.25,4927.829150305397,operating costs of operator1 + presow_till
31/Aug/1988,,0.25,4927.579150305397,operating costs of operator1 + sowing
01/Sep/1988,,0.75,4926.829150305397,operating costs of operator1 + presow_till
02/Sep/1988,,0.75,4926.079150305397,operating costs of operator1 + sowing
29/Sep/1988,,0.25,4925.829150305397,operating costs of operator1 + weeding
30/Sep/1988,,0.75,4925.079150305397,operating costs of operator1 + weeding
11/Dec/1988,358.0078326349431,,5283.08698294034,cropprice (maize)
11/Dec/1988,31.053147749999997,,5314.14013069034,cropprice (maize_residue)
11/Dec/1988,,0.25,5313.89013069034,operating costs of operator1 + harvesting
01/Jan/1989,0.0,,5313.89013069034,cropprice (maize)
01/Jan/1989,29.709457397727274,,5343.599588088067,cropprice (maize_residue)
01/Jan/1989,,0.75,5342.849588088067,operating costs of operator1 + harvesting
20/Jan/1989,,0.25,5342.599588088067,operating costs of operator1 + weeding
10/Feb/1989,,0.75,5341.849588088067,operating costs of operator1 + weeding
15/Mar/1989,,10.5,5331.349588088067,sowing costs
15/Mar/1989,,31.5,5299.849588088067,sowing costs
15/Mar/1989,,0.25,5299.599588088067,operating costs of operator1 + presow_till
16/Mar/1989,,0.25,5299.349588088067,operating costs of operator1 + sowing
17/Mar/1989,,0.75,5298.599588088067,operating costs of operator1 + presow_till
18/Mar/1989,,0.75,5297.849588088067,operating costs of operator1 + sowing
14/Apr/1989,,0.25,5297.599588088067,operating costs of operator1 + weeding
15/Apr/1989,,0.75,5296.849588088067,operating costs of operator1 + weeding
27/Jun/1989,415.6239416079545,,5712.473529696022,cropprice (bean)
27/Jun/1989,210.07938290198862,,5922.55291259801,cropprice (maize)
27/Jun/1989,49.94778719886363,,5972.500699796874,cropprice (maize_residue)
27/Jun/1989,,0.25,5972.250699796874,operating costs of operator1 + harvesting
28/Jun/1989,,0.25,5972.000699796874,operating costs of operator1 + harvesting
30/Jun/1989,,606.1,5365.900699796874,Farm Overheads
13/Jul/1989,0.0,,5365.900699796874,cropprice (maize)
13/Jul/1989,38.29145674431819,,5404.192156541192,cropprice (maize_residue)
13/Jul/1989,,0.75,5403.442156541192,operating costs of operator1 + harvesting
06/Aug/1989,,0.25,5403.192156541192,operating costs of operator1 + weeding
22/Aug/1989,,0.75,5402.442156541192,operating costs of operator1 + weeding
01/Sep/1989,,5.0,5397.442156541192,sowing costs
01/Sep/1989,,15.0,5382.442156541192,sowing costs
01/Sep/1989,,0.25,5382.192156541192,operating costs of operator1 + presow_till
02/Sep/1989,,0.25,5381.942156541192,operating costs of operator1 + sowing
03/Sep/1989,,0.75,5381.192156541192,operating costs of operator1 + presow_till
04/Sep/1989,,0.75,5380.442156541192,operating costs of operator1 + sowing
01/Oct/1989,,0.25,5380.192156541192,operating costs of operator1 + weeding
02/Oct/1989,,0.75,5379.442156541192,operating costs of operator1 + weeding
11/Dec/1989,331.6369140426137,,5711.079070583806,cropprice (maize)
11/Dec/1989,26.86010464772727,,5737.939175231533,cropprice (maize_residue)
11/Dec/1989,,0.25,5737.689175231533,operating costs of operator1 + harvesting
30/Dec/1989,0.0,,5737.689175231533,cropprice (maize)
30/Dec/1989,29.6666356875,,5767.3558109190335,cropprice (maize_residue)
30/Dec/1989,,0.75,5766.6058109190335,operating costs of operator1 + harvesting
20/Jan/1990,,0.25,5766.3558109190335,operating costs of operator1 + weeding
08/Feb/1990,,0.75,5765.6058109190335,operating costs of operator1 + weeding
15/Mar/1990,,10.5,5755.1058109190335,sowing costs
15/Mar/1990,,31.5,5723.6058109190335,sowing costs
15/Mar/1990,,0.25,5723.3558109190335,operating costs of operator1 + presow_till
16/Mar/1990,,0.25,5723.1058109190335,operating costs of operator1 + sowing
17/Mar/1990,,0.75,5722.3558109190335,operating costs of operator1 + presow_till
18/Mar/1990,,0.75,5721.6058109190335,operating costs of operator1 + sowing
14/Apr/1990,,0.25,5721.3558109190335,operating costs of operator1 + weeding
15/Apr/1990,,0.75,5720.6058109190335,operating costs of operator1 + weeding
24/Jun/1990,287.3901630170455,,6007.995973936079,cropprice (bean)
24/Jun/1990,265.9065091235796,,6273.902483059659,cropprice (maize)
24/Jun/1990,42.46366465909091,,6316.36614771875,cropprice (maize_residue)
24/Jun/1990,,0.25,6316.11614771875,operating costs of operator1 + harvesting
25/Jun/1990,,0.25,6315.86614771875,operating costs of operator1 + harvesting
30/Jun/1990,,606.1,5709.766147718749,Farm Overheads
05/Jul/1990,0.0,,5709.766147718749,cropprice (maize)
05/Jul/1990,40.109111437500005,,5749.87525915625,cropprice (maize_residue)
05/Jul/1990,,0.75,5749.12525915625,operating costs of operator1 + harvesting
03/Aug/1990,,0.25,5748.87525915625,operating costs of operator1 + weeding
14/Aug/1990,,0.75,5748.12525915625,operating costs of operator1 + weeding
01/Sep/1990,,5.0,5743.12525915625,sowing costs
01/Sep/1990,,15.0,5728.12525915625,sowing costs
01/Sep/1990,,0.25,5727.87525915625,operating costs of operator1 + presow_till
02/Sep/1990,,0.25,5727.62525915625,operating costs of operator1 + sowing
03/Sep/1990,,0.75,5726.87525915625,operating costs of operator1 + presow_till
04/Sep/1990,,0.75,5726.12525915625,operating costs of operator1 + sowing
01/Oct/1990,,0.25,5725.87525915625,operating costs of operator1 + weeding
02/Oct/1990,,0.75,5725.12525915625,operating costs of operator1 + weeding
14/Dec/1990,291.26413061931817,,6016.389389775568,cropprice (maize)
14/Dec/1990,23.42312899431818,,6039.812518769886,cropprice (maize_residue)
14/Dec/1990,,0.25,6039.562518769886,operating costs of operator1 + harvesting
02/Jan/1991,0.0,,6039.562518769886,cropprice (maize)
02/Jan/1991,35.629369568181815,,6075.191888338068,cropprice (maize_residue)
02/Jan/1991,,0.75,6074.441888338068,operating costs of operator1 + harvesting
23/Jan/1991,,0.25,6074.191888338068,operating costs of operator1 + weeding
11/Feb/1991,,0.75,6073.441888338068,operating costs of operator1 + weeding
27/Mar/1991,,10.5,6062.941888338068,sowing costs
27/Mar/1991,,31.5,6031.441888338068,sowing costs
27/Mar/1991,,0.25,6031.191888338068,operating costs of operator1 + presow_till
28/Mar/1991,,0.25,6030.941888338068,operating costs of operator1 + sowing
29/Mar/1991,,0.75,6030.191888338068,operating costs of operator1 + presow_till
30/Mar/1991,,0.75,6029.441888338068,operating costs of operator1 + sowing
26/Apr/1991,,0.25,6029.191888338068,operating costs of operator1 + weeding
27/Apr/1991,,0.75,6028.441888338068,operating costs of operator1 + weeding
30/Jun/1991,,606.1,5422.341888338067,Farm Overheads
06/Jul/1991,321.0758181988636,,5743.417706536931,cropprice (bean)
06/Jul/1991,265.49915498011364,,6008.916861517045,cropprice (maize)
06/Jul/1991,44.016251999999994,,6052.933113517045,cropprice (maize_residue)
06/Jul/1991,,0.25,6052.683113517045,operating costs of operator1 + harvesting
07/Jul/1991,,0.25,6052.433113517045,operating costs of operator1 + harvesting
13/Jul/1991,0.0,,6052.433113517045,cropprice (maize)
13/Jul/1991,45.523115676136364,,6097.956229193182,cropprice (maize_residue)
13/Jul/1991,,0.75,6097.206229193182,operating costs of operator1 + harvesting
15/Aug/1991,,0.25,6096.956229193182,operating costs of operator1 + weeding
22/Aug/1991,,0.75,6096.206229193182,operating costs of operator1 + weeding
02/Sep/1991,,5.0,6091.206229193182,sowing costs
02/Sep/1991,,15.0,6076.206229193182,sowing costs
02/Sep/1991,,0.25,6075.956229193182,operating costs of operator1 + presow_till
03/Sep/1991,,0.25,6075.706229193182,operating costs of operator1 + sowing
04/Sep/1991,,0.75,6074.956229193182,operating costs of operator1 + presow_till
05/Sep/1991,,0.75,6074.206229193182,operating costs of operator1 + sowing
02/Oct/1991,,0.25,6073.956229193182,operating costs of operator1 + weeding
03/Oct/1991,,0.75,6073.206229193182,operating costs of operator1 + weeding
13/Dec/1991,312.82665398011363,,6386.032883173295,cropprice (maize)
13/Dec/1991,21.90212735227273,,6407.935010525568,cropprice (maize_residue)
13/Dec/1991,,0.25,6407.685010525568,operating costs of operator1 + harvesting
02/Jan/1992,0.0,,6407.685010525568,cropprice (maize)
02/Jan/1992,28.031824278409093,,6435.716834803977,cropprice (maize_residue)
02/Jan/1992,,0.75,6434.966834803977,operating costs of operator1 + harvesting
22/Jan/1992,,0.25,6434.716834803977,operating costs of operator1 + weeding
11/Feb/1992,,0.75,6433.966834803977,operating costs of operator1 + weeding
01/Apr/1992,,10.5,6423.466834803977,sowing costs
01/Apr/1992,,31.5,6391.966834803977,sowing costs
01/Apr/1992,,0.25,6391.716834803977,operating costs of operator1 + presow_till
02/Apr/1992,,0.25,6391.466834803977,operating costs of operator1 + sowing
03/Apr/1992,,0.75,6390.716834803977,operating costs of operator1 + presow_till
04/Apr/1992,,0.75,6389.966834803977,operating costs of operator1 + sowing
01/May/1992,,0.25,6389.716834803977,operating costs of operator1 + weeding
02/May/1992,,0.75,6388.966834803977,operating costs of operator1 + weeding
29/Jun/1992,,606.1,5782.866834803976,Farm Overheads
11/Jul/1992,295.30093520454545,,6078.167770008522,cropprice (bean)
11/Jul/1992,317.0771339403409,,6395.244903948863,cropprice (maize)
11/Jul/1992,46.091036710227264,,6441.33594065909,cropprice (maize_residue)
11/Jul/1992,,0.25,6441.08594065909,operating costs of operator1 + harvesting
12/Jul/1992,279.65919116761364,,6720.745131826703,cropprice (maize)
12/Jul/1992,52.160073017045455,,6772.905204843749,cropprice (maize_residue)
12/Jul/1992,,0.25,6772.655204843749,operating costs of operator1 + harvesting
13/Jul/1992,,0.75,6771.905204843749,operating costs of operator1 + harvesting
20/Aug/1992,,0.25,6771.655204843749,operating costs of operator1 + weeding
21/Aug/1992,,0.75,6770.905204843749,operating costs of operator1 + weeding
31/Aug/1992,,5.0,6765.905204843749,sowing costs
31/Aug/1992,,15.0,6750.905204843749,sowing costs
31/Aug/1992,,0.25,6750.655204843749,operating costs of operator1 + presow_till
01/Sep/1992,,0.25,6750.405204843749,operating costs of operator1 + sowing
02/Sep/1992,,0.75,6749.655204843749,operating costs of operator1 + presow_till
03/Sep/1992,,0.75,6748.905204843749,operating costs of operator1 + sowing
30/Sep/1992,,0.25,6748.655204843749,operating costs of operator1 + weeding
01/Oct/1992,,0.75,6747.905204843749,operating costs of operator1 + weeding
13/Dec/1992,256.6402911690341,,7004.545496012783,cropprice (maize)
13/Dec/1992,18.87949718181818,,7023.424993194601,cropprice (maize_residue)
13/Dec/1992,,0.25,7023.174993194601,operating costs of operator1 + harvesting
30/Dec/1992,0.0,,7023.174993194601,cropprice (maize)
30/Dec/1992,41.30704984090909,,7064.482043035509,cropprice (maize_residue)
30/Dec/1992,,0.75,7063.732043035509,operating costs of operator1 + harvesting
22/Jan/1993,,0.25,7063.482043035509,operating costs of operator1 + weeding
08/Feb/1993,,0.75,7062.732043035509,operating costs of operator1 + weeding
15/Mar/1993,,10.5,7052.232043035509,sowing costs
15/Mar/1993,,31.5,7020.732043035509,sowing costs
15/Mar/1993,,0.25,7020.482043035509,operating costs of operator1 + presow_till
16/Mar/1993,,0.25,7020.232043035509,operating costs of operator1 + sowing
17/Mar/1993,,0.75,7019.482043035509,operating costs of operator1 + presow_till
18/Mar/1993,,0.75,7018.732043035509,operating costs of operator1 + sowing
14/Apr/1993,,0.25,7018.482043035509,operating costs of operator1 + weeding
15/Apr/1993,,0.75,7017.732043035509,operating costs of operator1 + weeding
20/Jun/1993,299.68739313068187,,7317.419436166191,cropprice (bean)
20/Jun/1993,210.9758510497159,,7528.395287215907,cropprice (maize)
20/Jun/1993,53.53297007954546,,7581.928257295453,cropprice (maize_residue)
20/Jun/1993,,0.25,7581.678257295453,operating costs of operator1 + harvesting
21/Jun/1993,,0.25,7581.428257295453,operating costs of operator1 + harvesting
30/Jun/1993,,606.1,6975.328257295452,Farm Overheads
04/Jul/1993,0.0,,6975.328257295452,cropprice (maize)
04/Jul/1993,40.16748879545454,,7015.495746090906,cropprice (maize_residue)
04/Jul/1993,,0.75,7014.745746090906,operating costs of operator1 + harvesting
30/Jul/1993,,0.25,7014.495746090906,operating costs of operator1 + weeding
13/Aug/1993,,0.75,7013.745746090906,operating costs of operator1 + weeding
05/Sep/1993,,5.0,7008.745746090906,sowing costs
05/Sep/1993,,15.0,6993.745746090906,sowing costs
05/Sep/1993,,0.25,6993.495746090906,operating costs of operator1 + presow_till
06/Sep/1993,,0.25,6993.245746090906,operating costs of operator1 + sowing
07/Sep/1993,,0.75,6992.495746090906,operating costs of operator1 + presow_till
08/Sep/1993,,0.75,6991.745746090906,operating costs of operator1 + sowing
05/Oct/1993,,0.25,6991.495746090906,operating costs of operator1 + weeding
06/Oct/1993,,0.75,6990.745746090906,operating costs of operator1 + weeding
13/Dec/1993,345.7734865525568,,7336.5192326434635,cropprice (maize)
13/Dec/1993,27.098507965909093,,7363.617740609373,cropprice (maize_residue)
13/Dec/1993,,0.25,7363.367740609373,operating costs of operator1 + harvesting
31/Dec/1993,0.0,,7363.367740609373,cropprice (maize)
31/Dec/1993,31.285741636363642,,7394.653482245737,cropprice (maize_residue)
31/Dec/1993,,0.75,7393.903482245737,operating costs of operator1 + harvesting
22/Jan/1994,,0.25,7393.653482245737,operating costs of operator1 + weeding
09/Feb/1994,,0.75,7392.903482245737,operating costs of operator1 + weeding
18/Mar/1994,,10.5,7382.403482245737,sowing costs
18/Mar/1994,,31.5,7350.903482245737,sowing costs
18/Mar/1994,,0.25,7350.653482245737,operating costs of operator1 + presow_till
19/Mar/1994,,0.25,7350.403482245737,operating costs of operator1 + sowing
20/Mar/1994,,0.75,7349.653482245737,operating costs of operator1 + presow_till
21/Mar/1994,,0.75,7348.903482245737,operating costs of operator1 + sowing
17/Apr/1994,,0.25,7348.653482245737,operating costs of operator1 + weeding
18/Apr/1994,,0.75,7347.903482245737,operating costs of operator1 + weeding
28/Jun/1994,530.8201404545456,,7878.723622700282,cropprice (bean)
28/Jun/1994,98.64583648295455,,7977.369459183236,cropprice (maize)
28/Jun/1994,66.66879549999999,,8044.038254683236,cropprice (maize_residue)
28/Jun/1994,,0.25,8043.788254683236,operating costs of operator1 + harvesting
29/Jun/1994,,0.25,8043.538254683236,operating costs of operator1 + harvesting
30/Jun/1994,,606.1,7437.438254683236,Farm Overheads
05/Jul/1994,0.0,,7437.438254683236,cropprice (maize)
05/Jul/1994,45.903546426136366,,7483.341801109372,cropprice (maize_residue)
05/Jul/1994,,0.75,7482.591801109372,operating costs of operator1 + harvesting
07/Aug/1994,,0.25,7482.341801109372,operating costs of operator1 + weeding
14/Aug/1994,,0.75,7481.591801109372,operating costs of operator1 + weeding
01/Sep/1994,,5.0,7476.591801109372,sowing costs
01/Sep/1994,,15.0,7461.591801109372,sowing costs
01/Sep/1994,,0.25,7461.341801109372,operating costs of operator1 + presow_till
02/Sep/1994,,0.25,7461.091801109372,operating costs of operator1 + sowing
03/Sep/1994,,0.75,7460.341801109372,operating costs of operator1 + presow_till
04/Sep/1994,,0.75,7459.591801109372,operating costs of operator1 + sowing
01/Oct/1994,,0.25,7459.341801109372,operating costs of operator1 + weeding
02/Oct/1994,,0.75,7458.591801109372,operating costs of operator1 + weeding
10/Dec/1994,354.06526246448857,,7812.657063573861,cropprice (maize)
10/Dec/1994,32.09920155113637,,7844.756265124997,cropprice (maize_residue)
10/Dec/1994,,0.25,7844.506265124997,operating costs of operator1 + harvesting
31/Dec/1994,0.0,,7844.506265124997,cropprice (maize)
31/Dec/1994,27.57997825568182,,7872.086243380679,cropprice (maize_residue)
31/Dec/1994,,0.75,7871.336243380679,operating costs of operator1 + harvesting
19/Jan/1995,,0.25,7871.086243380679,operating costs of operator1 + weeding
09/Feb/1995,,0.75,7870.336243380679,operating costs of operator1 + weeding
15/Mar/1995,,10.5,7859.836243380679,sowing costs
15/Mar/1995,,31.5,7828.336243380679,sowing costs
15/Mar/1995,,0.25,7828.086243380679,operating costs of operator1 + presow_till
16/Mar/1995,,0.25,7827.836243380679,operating costs of operator1 + sowing
17/Mar/1995,,0.75,7827.086243380679,operating costs of operator1 + presow_till
18/Mar/1995,,0.75,7826.336243380679,operating costs of operator1 + sowing
14/Apr/1995,,0.25,7826.086243380679,operating costs of operator1 + weeding
15/Apr/1995,,0.75,7825.336243380679,operating costs of operator1 + weeding
20/Jun/1995,221.4040041818182,,8046.740247562497,cropprice (bean)
20/Jun/1995,300.1675045482955,,8346.907752110792,cropprice (maize)
20/Jun/1995,45.73705499999999,,8392.644807110792,cropprice (maize_residue)
20/Jun/1995,,0.25,8392.394807110792,operating costs of operator1 + harvesting
21/Jun/1995,,0.25,8392.144807110792,operating costs of operator1 + harvesting
30/Jun/1995,,606.1,7786.044807110791,Farm Overheads
07/Jul/1995,0.0,,7786.044807110791,cropprice (maize)
07/Jul/1995,32.510758840909084,,7818.5555659517,cropprice (maize_residue)
07/Jul/1995,,0.75,7817.8055659517,operating costs of operator1 + harvesting
30/Jul/1995,,0.25,7817.5555659517,operating costs of operator1 + weeding
16/Aug/1995,,0.75,7816.8055659517,operating costs of operator1 + weeding
03/Sep/1995,,5.0,7811.8055659517,sowing costs
03/Sep/1995,,15.0,7796.8055659517,sowing costs
03/Sep/1995,,0.25,7796.5555659517,operating costs of operator1 + presow_till
04/Sep/1995,,0.25,7796.3055659517,operating costs of operator1 + sowing
05/Sep/1995,,0.75,7795.5555659517,operating costs of operator1 + presow_till
06/Sep/1995,,0.75,7794.8055659517,operating costs of operator1 + sowing
03/Oct/1995,,0.25,7794.5555659517,operating costs of operator1 + weeding
04/Oct/1995,,0.75,7793.8055659517,operating costs of operator1 + weeding
15/Dec/1995,345.9252976321023,,8139.730863583803,cropprice (maize)
15/Dec/1995,29.014346034090913,,8168.745209617893,cropprice (maize_residue)
15/Dec/1995,,0.25,8168.495209617893,operating costs of operator1 + harvesting
02/Jan/1996,0.0,,8168.495209617893,cropprice (maize)
02/Jan/1996,33.58525501704546,,8202.080464634939,cropprice (maize_residue)
02/Jan/1996,,0.75,8201.330464634939,operating costs of operator1 + harvesting
24/Jan/1996,,0.25,8201.080464634939,operating costs of operator1 + weeding
11/Feb/1996,,0.75,8200.330464634939,operating costs of operator1 + weeding
20/Mar/1996,,10.5,8189.830464634939,sowing costs
20/Mar/1996,,31.5,8158.330464634939,sowing costs
20/Mar/1996,,0.25,8158.080464634939,operating costs of operator1 + presow_till
21/Mar/1996,,0.25,8157.830464634939,operating costs of operator1 + sowing
22/Mar/1996,,0.75,8157.080464634939,operating costs of operator1 + presow_till
23/Mar/1996,,0.75,8156.330464634939,operating costs of operator1 + sowing
19/Apr/1996,,0.25,8156.080464634939,operating costs of operator1 + weeding
20/Apr/1996,,0.75,8155.330464634939,operating costs of operator1 + weeding
29/Jun/1996,460.66375866477273,,8615.994223299711,cropprice (bean)
29/Jun/1996,127.9146101377841,,8743.908833437496,cropprice (maize)
29/Jun/1996,60.80130282386364,,8804.71013626136,cropprice (maize_residue)
29/Jun/1996,,0.25,8804.46013626136,operating costs of operator1 + harvesting
29/Jun/1996,,606.1,8198.360136261359,Farm Overheads
30/Jun/1996,,0.25,8198.110136261359,operating costs of operator1 + harvesting
13/Jul/1996,0.0,,8198.110136261359,cropprice (maize)
13/Jul/1996,37.980210732954546,,8236.090346994313,cropprice (maize_residue)
13/Jul/1996,,0.75,8235.340346994313,operating costs of operator1 + harvesting
08/Aug/1996,,0.25,8235.090346994313,operating costs of operator1 + weeding
22/Aug/1996,,0.75,8234.340346994313,operating costs of operator1 + weeding
30/Aug/1996,,5.0,8229.340346994313,sowing costs
30/Aug/1996,,15.0,8214.340346994313,sowing costs
30/Aug/1996,,0.25,8214.090346994313,operating costs of operator1 + presow_till
31/Aug/1996,,0.25,8213.840346994313,operating costs of operator1 + sowing
01/Sep/1996,,0.75,8213.090346994313,operating costs of operator1 + presow_till
02/Sep/1996,,0.75,8212.340346994313,operating costs of operator1 + sowing
29/Sep/1996,,0.25,8212.090346994313,operating costs of operator1 + weeding
30/Sep/1996,,0.75,8211.340346994313,operating costs of operator1 + weeding
08/Dec/1996,345.83902529829544,,8557.179372292609,cropprice (maize)
08/Dec/1996,27.862659801136367,,8585.042032093745,cropprice (maize_residue)
08/Dec/1996,,0.25,8584.792032093745,operating costs of operator1 + harvesting
29/Dec/1996,0.0,,8584.792032093745,cropprice (maize)
29/Dec/1996,24.554174948863636,,8609.346207042609,cropprice (maize_residue)
29/Dec/1996,,0.75,8608.596207042609,operating costs of operator1 + harvesting
17/Jan/1997,,0.25,8608.346207042609,operating costs of operator1 + weeding
07/Feb/1997,,0.75,8607.596207042609,operating costs of operator1 + weeding
27/Mar/1997,,10.5,8597.096207042609,sowing costs
27/Mar/1997,,31.5,8565.596207042609,sowing costs
27/Mar/1997,,0.25,8565.346207042609,operating costs of operator1 + presow_till
28/Mar/1997,,0.25,8565.096207042609,operating costs of operator1 + sowing
29/Mar/1997,,0.75,8564.346207042609,operating costs of operator1 + presow_till
30/Mar/1997,,0.75,8563.596207042609,operating costs of operator1 + sowing
26/Apr/1997,,0.25,8563.346207042609,operating costs of operator1 + weeding
27/Apr/1997,,0.75,8562.596207042609,operating costs of operator1 + weeding
30/Jun/1997,,606.1,7956.496207042608,Farm Overheads
06/Jul/1997,294.70347040909087,,8251.1996774517,cropprice (bean)
06/Jul/1997,326.1659817400568,,8577.365659191755,cropprice (maize)
06/Jul/1997,48.739507499999995,,8626.105166691756,cropprice (maize_residue)
06/Jul/1997,,0.25,8625.855166691756,operating costs of operator1 + harvesting
07/Jul/1997,,0.25,8625.605166691756,operating costs of operator1 + harvesting
13/Jul/1997,0.0,,8625.605166691756,cropprice (maize)
13/Jul/1997,45.58667824431819,,8671.191844936075,cropprice (maize_residue)
13/Jul/1997,,0.75,8670.441844936075,operating costs of operator1 + harvesting
15/Aug/1997,,0.25,8670.191844936075,operating costs of operator1 + weeding
22/Aug/1997,,0.75,8669.441844936075,operating costs of operator1 + weeding
11/Oct/1997,,5.0,8664.441844936075,sowing costs
11/Oct/1997,,15.0,8649.441844936075,sowing costs
11/Oct/1997,,0.25,8649.191844936075,operating costs of operator1 + presow_till
12/Oct/1997,,0.25,8648.941844936075,operating costs of operator1 + sowing
13/Oct/1997,,0.75,8648.191844936075,operating costs of operator1 + presow_till
14/Oct/1997,,0.75,8647.441844936075,operating costs of operator1 + sowing
10/Nov/1997,,0.25,8647.191844936075,operating costs of operator1 + weeding
11/Nov/1997,,0.75,8646.441844936075,operating costs of operator1 + weeding
19/Jan/1998,331.37843159232955,,8977.820276528404,cropprice (maize)
19/Jan/1998,26.543235085227273,,9004.363511613632,cropprice (maize_residue)
19/Jan/1998,,0.25,9004.113511613632,operating costs of operator1 + harvesting
04/Feb/1998,0.0,,9004.113511613632,cropprice (maize)
04/Feb/1998,32.362572409090916,,9036.476084022723,cropprice (maize_residue)
04/Feb/1998,,0.75,9035.726084022723,operating costs of operator1 + harvesting
28/Feb/1998,,0.25,9035.476084022723,operating costs of operator1 + weeding
16/Mar/1998,,0.75,9034.726084022723,operating costs of operator1 + weeding
26/Mar/1998,,10.5,9024.226084022723,sowing costs
26/Mar/1998,,31.5,8992.726084022723,sowing costs
26/Mar/1998,,0.25,8992.476084022723,operating costs of operator1 + presow_till
27/Mar/1998,,0.25,8992.226084022723,operating costs of operator1 + sowing
28/Mar/1998,,0.75,8991.476084022723,operating costs of operator1 + presow_till
29/Mar/1998,,0.75,8990.726084022723,operating costs of operator1 + sowing
25/Apr/1998,,0.25,8990.476084022723,operating costs of operator1 + weeding
26/Apr/1998,,0.75,8989.726084022723,operating costs of operator1 + weeding
30/Jun/1998,,606.1,8383.626084022722,Farm Overheads
03/Jul/1998,364.7947457556818,,8748.420829778404,cropprice (bean)
03/Jul/1998,9.285184785511364,,8757.706014563915,cropprice (maize)
03/Jul/1998,60.39166814772727,,8818.097682711643,cropprice (maize_residue)
03/Jul/1998,,0.25,8817.847682711643,operating costs of operator1 + harvesting
04/Jul/1998,,0.25,8817.597682711643,operating costs of operator1 + harvesting
19/Jul/1998,0.0,,8817.597682711643,cropprice (maize)
19/Jul/1998,26.58100474431818,,8844.17868745596,cropprice (maize_residue)
19/Jul/1998,,0.75,8843.42868745596,operating costs of operator1 + harvesting
12/Aug/1998,,0.25,8843.17868745596,operating costs of operator1 + weeding
28/Aug/1998,,0.75,8842.42868745596,operating costs of operator1 + weeding
01/Sep/1998,,5.0,8837.42868745596,sowing costs
01/Sep/1998,,15.0,8822.42868745596,sowing costs
01/Sep/1998,,0.25,8822.17868745596,operating costs of operator1 + presow_till
02/Sep/1998,,0.25,8821.92868745596,operating costs of operator1 + sowing
03/Sep/1998,,0.75,8821.17868745596,operating costs of operator1 + presow_till
04/Sep/1998,,0.75,8820.42868745596,operating costs of operator1 + sowing
01/Oct/1998,,0.25,8820.17868745596,operating costs of operator1 + weeding
02/Oct/1998,,0.75,8819.42868745596,operating costs of operator1 + weeding
11/Dec/1998,269.3259775014204,,9088.754664957381,cropprice (maize)
11/Dec/1998,18.539115210227273,,9107.293780167609,cropprice (maize_residue)
11/Dec/1998,,0.25,9107.043780167609,operating costs of operator1 + harvesting
28/Dec/1998,0.0,,9107.043780167609,cropprice (maize)
28/Dec/1998,30.700532386363637,,9137.744312553972,cropprice (maize_residue)
28/Dec/1998,,0.75,9136.994312553972,operating costs of operator1 + harvesting
20/Jan/1999,,0.25,9136.744312553972,operating costs of operator1 + weeding
06/Feb/1999,,0.75,9135.994312553972,operating costs of operator1 + weeding
15/Mar/1999,,10.5,9125.494312553972,sowing costs
15/Mar/1999,,31.5,9093.994312553972,sowing costs
15/Mar/1999,,0.25,9093.744312553972,operating costs of operator1 + presow_till
16/Mar/1999,,0.25,9093.494312553972,operating costs of operator1 + sowing
17/Mar/1999,,0.75,9092.744312553972,operating costs of operator1 + presow_till
18/Mar/1999,,0.75,9091.994312553972,operating costs of operator1 + sowing
14/Apr/1999,,0.25,9091.744312553972,operating costs of operator1 + weeding
15/Apr/1999,,0.75,9090.994312553972,operating costs of operator1 + weeding
24/Jun/1999,332.8553717045454,,9423.849684258517,cropprice (bean)
24/Jun/1999,250.74167013494318,,9674.59135439346,cropprice (maize)
24/Jun/1999,50.28458473863636,,9724.875939132096,cropprice (maize_residue)
24/Jun/1999,,0.25,9724.625939132096,operating costs of operator1 + harvesting
25/Jun/1999,,0.25,9724.375939132096,operating costs of operator1 + harvesting
30/Jun/1999,,606.1,9118.275939132096,Farm Overheads
10/Jul/1999,0.0,,9118.275939132096,cropprice (maize)
10/Jul/1999,36.12789917045455,,9154.40383830255,cropprice (maize_residue)
10/Jul/1999,,0.75,9153.65383830255,operating costs of operator1 + harvesting
03/Aug/1999,,0.25,9153.40383830255,operating costs of operator1 + weeding
19/Aug/1999,,0.75,9152.65383830255,operating costs of operator1 + weeding
01/Sep/1999,,5.0,9147.65383830255,sowing costs
01/Sep/1999,,15.0,9132.65383830255,sowing costs
01/Sep/1999,,0.25,9132.40383830255,operating costs of operator1 + presow_till
02/Sep/1999,,0.25,9132.15383830255,operating costs of operator1 + sowing
03/Sep/1999,,0.75,9131.40383830255,operating costs of operator1 + presow_till
04/Sep/1999,,0.75,9130.65383830255,operating costs of operator1 + sowing
01/Oct/1999,,0.25,9130.40383830255,operating costs of operator1 + weeding
02/Oct/1999,,0.75,9129.65383830255,operating costs of operator1 + weeding
12/Dec/1999,336.5963145809659,,9466.250152883516,cropprice (maize)
12/Dec/1999,26.04633955681818,,9492.296492440335,cropprice (maize_residue)
12/Dec/1999,,0.25,9492.046492440335,operating costs of operator1 + harvesting
02/Jan/2000,0.0,,9492.046492440335,cropprice (maize)
02/Jan/2000,23.595274500000002,,9515.641766940334,cropprice (maize_residue)
02/Jan/2000,,0.75,9514.891766940334,operating costs of operator1 + harvesting
21/Jan/2000,,0.25,9514.641766940334,operating costs of operator1 + weeding
11/Feb/2000,,0.75,9513.891766940334,operating costs of operator1 + weeding
19/Mar/2000,,10.5,9503.391766940334,sowing costs
19/Mar/2000,,31.5,9471.891766940334,sowing costs
19/Mar/2000,,0.25,9471.641766940334,operating costs of operator1 + presow_till
20/Mar/2000,,0.25,9471.391766940334,operating costs of operator1 + sowing
21/Mar/2000,,0.75,9470.641766940334,operating costs of operator1 + presow_till
22/Mar/2000,,0.75,9469.891766940334,operating costs of operator1 + sowing
18/Apr/2000,,0.25,9469.641766940334,operating costs of operator1 + weeding
19/Apr/2000,,0.75,9468.891766940334,operating costs of operator1 + weeding
23/Jun/2000,85.25537522727274,,9554.147142167607,cropprice (bean)
23/Jun/2000,314.97592107954546,,9869.123063247152,cropprice (maize)
23/Jun/2000,32.67726828977273,,9901.800331536926,cropprice (maize_residue)
23/Jun/2000,,0.25,9901.550331536926,operating costs of operator1 + harvesting
24/Jun/2000,,0.25,9901.300331536926,operating costs of operator1 + harvesting
29/Jun/2000,,606.1,9295.200331536926,Farm Overheads
01/Jul/2000,0.0,,9295.200331536926,cropprice (maize)
01/Jul/2000,49.43714904545455,,9344.63748058238,cropprice (maize_residue)
01/Jul/2000,,0.75,9343.88748058238,operating costs of operator1 + harvesting
02/Aug/2000,,0.25,9343.63748058238,operating costs of operator1 + weeding
10/Aug/2000,,0.75,9342.88748058238,operating costs of operator1 + weeding
30/Aug/2000,,5.0,9337.88748058238,sowing costs
30/Aug/2000,,15.0,9322.88748058238,sowing costs
30/Aug/2000,,0.25,9322.63748058238,operating costs of operator1 + presow_till
31/Aug/2000,,0.25,9322.38748058238,operating costs of operator1 + sowing
01/Sep/2000,,0.75,9321.63748058238,operating costs of operator1 + presow_till
02/Sep/2000,,0.75,9320.88748058238,operating costs of operator1 + sowing
29/Sep/2000,,0.25,9320.63748058238,operating costs of operator1 + weeding
30/Sep/2000,,0.75,9319.88748058238,operating costs of operator1 + weeding
08/Dec/2000,232.42280852982952,,9552.310289112209,cropprice (maize)
08/Dec/2000,16.456218375,,9568.76650748721,cropprice (maize_residue)
08/Dec/2000,,0.25,9568.51650748721,operating costs of operator1 + harvesting
30/Dec/2000,0.0,,9568.51650748721,cropprice (maize)
30/Dec/2000,20.409255988636364,,9588.925763475845,cropprice (maize_residue)
30/Dec/2000,,0.75,9588.175763475845,operating costs of operator1 + harvesting
17/Jan/2001,,0.25,9587.925763475845,operating costs of operator1 + weeding
08/Feb/2001,,0.75,9587.175763475845,operating costs of operator1 + weeding
15/Mar/2001,,10.5,9576.675763475845,sowing costs
15/Mar/2001,,31.5,9545.175763475845,sowing costs
15/Mar/2001,,0.25,9544.925763475845,operating costs of operator1 + presow_till
16/Mar/2001,,0.25,9544.675763475845,operating costs of operator1 + sowing
17/Mar/2001,,0.75,9543.925763475845,operating costs of operator1 + presow_till
18/Mar/2001,,0.75,9543.175763475845,operating costs of operator1 + sowing
14/Apr/2001,,0.25,9542.925763475845,operating costs of operator1 + weeding
15/Apr/2001,,0.75,9542.175763475845,operating costs of operator1 + weeding
23/Jun/2001,460.67520700568184,,10002.850970481526,cropprice (bean)
23/Jun/2001,110.26912378124999,,10113.120094262777,cropprice (maize)
23/Jun/2001,63.349143289772734,,10176.46923755255,cropprice (maize_residue)
23/Jun/2001,,0.25,10176.21923755255,operating costs of operator1 + harvesting
24/Jun/2001,,0.25,10175.96923755255,operating costs of operator1 + harvesting
30/Jun/2001,,606.1,9569.86923755255,Farm Overheads
06/Jul/2001,0.0,,9569.86923755255,cropprice (maize)
06/Jul/2001,34.40241935795455,,9604.271656910505,cropprice (maize_residue)
06/Jul/2001,,0.75,9603.521656910505,operating costs of operator1 + harvesting
02/Aug/2001,,0.25,9603.271656910505,operating costs of operator1 + weeding
15/Aug/2001,,0.75,9602.521656910505,operating costs of operator1 + weeding
01/Sep/2001,,5.0,9597.521656910505,sowing costs
01/Sep/2001,,15.0,9582.521656910505,sowing costs
01/Sep/2001,,0.25,9582.271656910505,operating costs of operator1 + presow_till
02/Sep/2001,,0.25,9582.021656910505,operating costs of operator1 + sowing
03/Sep/2001,,0.75,9581.271656910505,operating costs of operator1 + presow_till
04/Sep/2001,,0.75,9580.521656910505,operating costs of operator1 + sowing
01/Oct/2001,,0.25,9580.271656910505,operating costs of operator1 + weeding
02/Oct/2001,,0.75,9579.521656910505,operating costs of operator1 + weeding
08/Dec/2001,346.72772444318184,,9926.249381353688,cropprice (maize)
08/Dec/2001,25.88691295454545,,9952.136294308233,cropprice (maize_residue)
08/Dec/2001,,0.25,9951.886294308233,operating costs of operator1 + harvesting
28/Dec/2001,0.0,,9951.886294308233,cropprice (maize)
28/Dec/2001,22.536159170454543,,9974.422453478688,cropprice (maize_residue)
28/Dec/2001,,0.75,9973.672453478688,operating costs of operator1 + harvesting
17/Jan/2002,,0.25,9973.422453478688,operating costs of operator1 + weeding
06/Feb/2002,,0.75,9972.672453478688,operating costs of operator1 + weeding
15/Mar/2002,,10.5,9962.172453478688,sowing costs
15/Mar/2002,,31.5,9930.672453478688,sowing costs
15/Mar/2002,,0.25,9930.422453478688,operating costs of operator1 + presow_till
16/Mar/2002,,0.25,9930.172453478688,operating costs of operator1 + sowing
17/Mar/2002,,0.75,9929.422453478688,operating costs of operator1 + presow_till
18/Mar/2002,,0.75,9928.672453478688,operating costs of operator1 + sowing
14/Apr/2002,,0.25,9928.422453478688,operating costs of operator1 + weeding
15/Apr/2002,,0.75,9927.672453478688,operating costs of operator1 + weeding
19/Jun/2002,264.61539252272723,,10192.287846001414,cropprice (bean)
19/Jun/2002,233.17327822159092,,10425.461124223006,cropprice (maize)
19/Jun/2002,47.145996096590906,,10472.607120319597,cropprice (maize_residue)
19/Jun/2002,,0.25,10472.357120319597,operating costs of operator1 + harvesting
20/Jun/2002,,0.25,10472.107120319597,operating costs of operator1 + harvesting
29/Jun/2002,0.0,,10472.107120319597,cropprice (maize)
29/Jun/2002,38.618895102272724,,10510.72601542187,cropprice (maize_residue)
29/Jun/2002,,0.75,10509.97601542187,operating costs of operator1 + harvesting
30/Jun/2002,,606.1,9903.876015421869,Farm Overheads
29/Jul/2002,,0.25,9903.626015421869,operating costs of operator1 + weeding
08/Aug/2002,,0.75,9902.876015421869,operating costs of operator1 + weeding
03/Sep/2002,,5.0,9897.876015421869,sowing costs
03/Sep/2002,,15.0,9882.876015421869,sowing costs
03/Sep/2002,,0.25,9882.626015421869,operating costs of operator1 + presow_till
04/Sep/2002,,0.25,9882.376015421869,operating costs of operator1 + sowing
05/Sep/2002,,0.75,9881.626015421869,operating costs of operator1 + presow_till
06/Sep/2002,,0.75,9880.876015421869,operating costs of operator1 + sowing
03/Oct/2002,,0.25,9880.626015421869,operating costs of operator1 + weeding
04/Oct/2002,,0.75,9879.876015421869,operating costs of operator1 + weeding
08/Dec/2002,344.1969285724432,,10224.072943994312,cropprice (maize)
08/Dec/2002,25.33271928409091,,10249.405663278403,cropprice (maize_residue)
08/Dec/2002,,0.25,10249.155663278403,operating costs of operator1 + harvesting
28/Dec/2002,0.0,,10249.155663278403,cropprice (maize)
28/Dec/2002,24.842089568181816,,10273.997752846584,cropprice (maize_residue)
28/Dec/2002,,0.75,10273.247752846584,operating costs of operator1 + harvesting
17/Jan/2003,,0.25,10272.997752846584,operating costs of operator1 + weeding
06/Feb/2003,,0.75,10272.247752846584,operating costs of operator1 + weeding
27/Mar/2003,,10.5,10261.747752846584,sowing costs
27/Mar/2003,,31.5,10230.247752846584,sowing costs
27/Mar/2003,,0.25,10229.997752846584,operating costs of operator1 + presow_till
28/Mar/2003,,0.25,10229.747752846584,operating costs of operator1 + sowing
29/Mar/2003,,0.75,10228.997752846584,operating costs of operator1 + presow_till
30/Mar/2003,,0.75,10228.247752846584,operating costs of operator1 + sowing
26/Apr/2003,,0.25,10227.997752846584,operating costs of operator1 + weeding
27/Apr/2003,,0.75,10227.247752846584,operating costs of operator1 + weeding
30/Jun/2003,,606.1,9621.147752846584,Farm Overheads
02/Jul/2003,90.76041927272729,,9711.90817211931,cropprice (bean)
02/Jul/2003,306.08964480255685,,10017.997816921867,cropprice (maize)
02/Jul/2003,28.40313165909091,,10046.400948580958,cropprice (maize_residue)
02/Jul/2003,,0.25,10046.150948580958,operating costs of operator1 + harvesting
03/Jul/2003,,0.25,10045.900948580958,operating costs of operator1 + harvesting
10/Jul/2003,0.0,,10045.900948580958,cropprice (maize)
10/Jul/2003,40.88940707386363,,10086.790355654823,cropprice (maize_residue)
10/Jul/2003,,0.75,10086.040355654823,operating costs of operator1 + harvesting
11/Aug/2003,,0.25,10085.790355654823,operating costs of operator1 + weeding
19/Aug/2003,,0.75,10085.040355654823,operating costs of operator1 + weeding
03/Sep/2003,,5.0,10080.040355654823,sowing costs
03/Sep/2003,,15.0,10065.040355654823,sowing costs
03/Sep/2003,,0.25,10064.790355654823,operating costs of operator1 + presow_till
04/Sep/2003,,0.25,10064.540355654823,operating costs of operator1 + sowing
05/Sep/2003,,0.75,10063.790355654823,operating costs of operator1 + presow_till
06/Sep/2003,,0.75,10063.040355654823,operating costs of operator1 + sowing
03/Oct/2003,,0.25,10062.790355654823,operating costs of operator1 + weeding
04/Oct/2003,,0.75,10062.040355654823,operating costs of operator1 + weeding
11/Dec/2003,5.499155399147726,,10067.53951105397,cropprice (maize)
11/Dec/2003,17.999128863636365,,10085.538639917606,cropprice (maize_residue)
11/Dec/2003,,0.25,10085.288639917606,operating costs of operator1 + harvesting
01/Jan/2004,0.0,,10085.288639917606,cropprice (maize)
01/Jan/2004,15.969200130681816,,10101.257840048287,cropprice (maize_residue)
01/Jan/2004,,0.75,10100.507840048287,operating costs of operator1 + harvesting
20/Jan/2004,,0.25,10100.257840048287,operating costs of operator1 + weeding
10/Feb/2004,,0.75,10099.507840048287,operating costs of operator1 + weeding
14/Mar/2004,,10.5,10089.007840048287,sowing costs
14/Mar/2004,,31.5,10057.507840048287,sowing costs
14/Mar/2004,,0.25,10057.257840048287,operating costs of operator1 + presow_till
15/Mar/2004,,0.25,10057.007840048287,operating costs of operator1 + sowing
16/Mar/2004,,0.75,10056.257840048287,operating costs of operator1 + presow_till
17/Mar/2004,,0.75,10055.507840048287,operating costs of operator1 + sowing
13/Apr/2004,,0.25,10055.257840048287,operating costs of operator1 + weeding
14/Apr/2004,,0.75,10054.507840048287,operating costs of operator1 + weeding
23/Jun/2004,0.0,,10054.507840048287,cropprice (maize)
23/Jun/2004,41.599107221590906,,10096.106947269878,cropprice (maize_residue)
23/Jun/2004,,0.75,10095.356947269878,operating costs of operator1 + harvesting
25/Jun/2004,403.5790100284091,,10498.935957298287,cropprice (bean)
25/Jun/2004,0.0,,10498.935957298287,cropprice (maize)
25/Jun/2004,50.569835318181816,,10549.505792616468,cropprice (maize_residue)
25/Jun/2004,,0.25,10549.255792616468,operating costs of operator1 + harvesting
26/Jun/2004,,0.25,10549.005792616468,operating costs of operator1 + harvesting
29/Jun/2004,,606.1,9942.905792616468,Farm Overheads
02/Aug/2004,,0.75,9942.155792616468,operating costs of operator1 + weeding
04/Aug/2004,,0.25,9941.905792616468,operating costs of operator1 + weeding
04/Sep/2004,,5.0,9936.905792616468,sowing costs
04/Sep/2004,,15.0,9921.905792616468,sowing costs
04/Sep/2004,,0.25,9921.655792616468,operating costs of operator1 + presow_till
05/Sep/2004,,0.25,9921.405792616468,operating costs of operator1 + sowing
06/Sep/2004,,0.75,9920.655792616468,operating costs of operator1 + presow_till
07/Sep/2004,,0.75,9919.905792616468,operating costs of operator1 + sowing
04/Oct/2004,,0.25,9919.655792616468,operating costs of operator1 + weeding
05/Oct/2004,,0.75,9918.905792616468,operating costs of operator1 + weeding
10/Dec/2004,237.7564662911932,,10156.662258907661,cropprice (maize)
10/Dec/2004,15.713964289772726,,10172.376223197434,cropprice (maize_residue)
10/Dec/2004,,0.25,10172.126223197434,operating costs of operator1 + harvesting
30/Dec/2004,0.0,,10172.126223197434,cropprice (maize)
30/Dec/2004,20.711047090909094,,10192.837270288343,cropprice (maize_residue)
30/Dec/2004,,0.75,10192.087270288343,operating costs of operator1 + harvesting
19/Jan/2005,,0.25,10191.837270288343,operating costs of operator1 + weeding
08/Feb/2005,,0.75,10191.087270288343,operating costs of operator1 + weeding
22/Mar/2005,,10.5,10180.587270288343,sowing costs
22/Mar/2005,,31.5,10149.087270288343,sowing costs
22/Mar/2005,,0.25,10148.837270288343,operating costs of operator1 + presow_till
23/Mar/2005,,0.25,10148.587270288343,operating costs of operator1 + sowing
24/Mar/2005,,0.75,10147.837270288343,operating costs of operator1 + presow_till
25/Mar/2005,,0.75,10147.087270288343,operating costs of operator1 + sowing
21/Apr/2005,,0.25,10146.837270288343,operating costs of operator1 + weeding
22/Apr/2005,,0.75,10146.087270288343,operating costs of operator1 + weeding
25/Jun/2005,91.23599517613638,,10237.323265464478,cropprice (bean)
25/Jun/2005,316.8940868607954,,10554.217352325273,cropprice (maize)
25/Jun/2005,30.28917902272727,,10584.506531348,cropprice (maize_residue)
25/Jun/2005,,0.25,10584.256531348,operating costs of operator1 + harvesting
26/Jun/2005,,0.25,10584.006531348,operating costs of operator1 + harvesting
30/Jun/2005,,606.1,9977.906531348,Farm Overheads
03/Jul/2005,0.0,,9977.906531348,cropprice (maize)
03/Jul/2005,40.198932988636365,,10018.105464336637,cropprice (maize_residue)
03/Jul/2005,,0.75,10017.355464336637,operating costs of operator1 + harvesting
04/Aug/2005,,0.25,10017.105464336637,operating costs of operator1 + weeding
12/Aug/2005,,0.75,10016.355464336637,operating costs of operator1 + weeding
01/Sep/2005,,5.0,10011.355464336637,sowing costs
01/Sep/2005,,15.0,9996.355464336637,sowing costs
01/Sep/2005,,0.25,9996.105464336637,operating costs of operator1 + presow_till
02/Sep/2005,,0.25,9995.855464336637,operating costs of operator1 + sowing
03/Sep/2005,,0.75,9995.105464336637,operating costs of operator1 + presow_till
04/Sep/2005,,0.75,9994.355464336637,operating costs of operator1 + sowing
01/Oct/2005,,0.25,9994.105464336637,operating costs of operator1 + weeding
02/Oct/2005,,0.75,9993.355464336637,operating costs of operator1 + weeding
09/Dec/2005,0.0,,9993.355464336637,cropprice (maize)
09/Dec/2005,18.178436278409087,,10011.533900615046,cropprice (maize_residue)
09/Dec/2005,,0.25,10011.283900615046,operating costs of operator1 + harvesting
27/Dec/2005,0.0,,10011.283900615046,cropprice (maize)
27/Dec/2005,13.674147869318181,,10024.958048484365,cropprice (maize_residue)
27/Dec/2005,,0.75,10024.208048484365,operating costs of operator1 + harvesting
18/Jan/2006,,0.25,10023.958048484365,operating costs of operator1 + weeding
05/Feb/2006,,0.75,10023.208048484365,operating costs of operator1 + weeding
19/Mar/2006,,10.5,10012.708048484365,sowing costs
19/Mar/2006,,31.5,9981.208048484365,sowing costs
19/Mar/2006,,0.25,9980.958048484365,operating costs of operator1 + presow_till
20/Mar/2006,,0.25,9980.708048484365,operating costs of operator1 + sowing
21/Mar/2006,,0.75,9979.958048484365,operating costs of operator1 + presow_till
22/Mar/2006,,0.75,9979.208048484365,operating costs of operator1 + sowing
18/Apr/2006,,0.25,9978.958048484365,operating costs of operator1 + weeding
19/Apr/2006,,0.75,9978.208048484365,operating costs of operator1 + weeding
30/Jun/2006,,606.1,9372.108048484364,Farm Overheads
11/Jul/2006,713.4636508125,,10085.571699296865,cropprice (bean)
11/Jul/2006,0.0,,10085.571699296865,cropprice (maize)
11/Jul/2006,46.27420321590908,,10131.845902512774,cropprice (maize_residue)
11/Jul/2006,0.0,,10131.845902512774,cropprice (maize)
11/Jul/2006,31.853152193181817,,10163.699054705956,cropprice (maize_residue)
11/Jul/2006,,0.25,10163.449054705956,operating costs of operator1 + harvesting
12/Jul/2006,,0.25,10163.199054705956,operating costs of operator1 + harvesting
13/Jul/2006,,0.75,10162.449054705956,operating costs of operator1 + harvesting
20/Aug/2006,,0.25,10162.199054705956,operating costs of operator1 + weeding
21/Aug/2006,,0.75,10161.449054705956,operating costs of operator1 + weeding
01/Sep/2006,,5.0,10156.449054705956,sowing costs
01/Sep/2006,,15.0,10141.449054705956,sowing costs
01/Sep/2006,,0.25,10141.199054705956,operating costs of operator1 + presow_till
02/Sep/2006,,0.25,10140.949054705956,operating costs of operator1 + sowing
03/Sep/2006,,0.75,10140.199054705956,operating costs of operator1 + presow_till
04/Sep/2006,,0.75,10139.449054705956,operating costs of operator1 + sowing
01/Oct/2006,,0.25,10139.199054705956,operating costs of operator1 + weeding
02/Oct/2006,,0.75,10138.449054705956,operating costs of operator1 + weeding
08/Dec/2006,320.3091510980114,,10458.758205803968,cropprice (maize)
08/Dec/2006,19.61702103977273,,10478.37522684374,cropprice (maize_residue)
08/Dec/2006,,0.25,10478.12522684374,operating costs of operator1 + harvesting
31/Dec/2006,0.0,,10478.12522684374,cropprice (maize)
31/Dec/2006,22.02414634090909,,10500.14937318465,cropprice (maize_residue)
31/Dec/2006,,0.75,10499.39937318465,operating costs of operator1 + harvesting
17/Jan/2007,,0.25,10499.14937318465,operating costs of operator1 + weeding
09/Feb/2007,,0.75,10498.39937318465,operating costs of operator1 + weeding
18/Mar/2007,,10.5,10487.89937318465,sowing costs
18/Mar/2007,,31.5,10456.39937318465,sowing costs
18/Mar/2007,,0.25,10456.14937318465,operating costs of operator1 + presow_till
19/Mar/2007,,0.25,10455.89937318465,operating costs of operator1 + sowing
20/Mar/2007,,0.75,10455.14937318465,operating costs of operator1 + presow_till
21/Mar/2007,,0.75,10454.39937318465,operating costs of operator1 + sowing
17/Apr/2007,,0.25,10454.14937318465,operating costs of operator1 + weeding
18/Apr/2007,,0.75,10453.39937318465,operating costs of operator1 + weeding
21/Jun/2007,88.44953989772728,,10541.848913082376,cropprice (bean)
21/Jun/2007,326.71165326562505,,10868.560566348002,cropprice (maize)
21/Jun/2007,33.475044943181814,,10902.035611291183,cropprice (maize_residue)
21/Jun/2007,,0.25,10901.785611291183,operating costs of operator1 + harvesting
22/Jun/2007,,0.25,10901.535611291183,operating costs of operator1 + harvesting
30/Jun/2007,,606.1,10295.435611291183,Farm Overheads
08/Jul/2007,0.0,,10295.435611291183,cropprice (maize)
08/Jul/2007,32.62355596022727,,10328.05916725141,cropprice (maize_residue)
08/Jul/2007,,0.75,10327.30916725141,operating costs of operator1 + harvesting
31/Jul/2007,,0.25,10327.05916725141,operating costs of operator1 + weeding
17/Aug/2007,,0.75,10326.30916725141,operating costs of operator1 + weeding
01/Sep/2007,,5.0,10321.30916725141,sowing costs
01/Sep/2007,,15.0,10306.30916725141,sowing costs
01/Sep/2007,,0.25,10306.05916725141,operating costs of operator1 + presow_till
02/Sep/2007,,0.25,10305.80916725141,operating costs of operator1 + sowing
03/Sep/2007,,0.75,10305.05916725141,operating costs of operator1 + presow_till
04/Sep/2007,,0.75,10304.30916725141,operating costs of operator1 + sowing
01/Oct/2007,,0.25,10304.05916725141,operating costs of operator1 + weeding
02/Oct/2007,,0.75,10303.30916725141,operating costs of operator1 + weeding
10/Dec/2007,130.24444165909088,,10433.5536089105,cropprice (maize)
10/Dec/2007,17.583192306818184,,10451.136801217319,cropprice (maize_residue)
10/Dec/2007,,0.25,10450.886801217319,operating costs of operator1 + harvesting
03/Jan/2008,0.0,,10450.886801217319,cropprice (maize)
03/Jan/2008,18.89731251136363,,10469.784113728683,cropprice (maize_residue)
03/Jan/2008,,0.75,10469.034113728683,operating costs of operator1 + harvesting
19/Jan/2008,,0.25,10468.784113728683,operating costs of operator1 + weeding
12/Feb/2008,,0.75,10468.034113728683,operating costs of operator1 + weeding
17/Mar/2008,,10.5,10457.534113728683,sowing costs
17/Mar/2008,,31.5,10426.034113728683,sowing costs
17/Mar/2008,,0.25,10425.784113728683,operating costs of operator1 + presow_till
18/Mar/2008,,0.25,10425.534113728683,operating costs of operator1 + sowing
19/Mar/2008,,0.75,10424.784113728683,operating costs of operator1 + presow_till
20/Mar/2008,,0.75,10424.034113728683,operating costs of operator1 + sowing
16/Apr/2008,,0.25,10423.784113728683,operating costs of operator1 + weeding
17/Apr/2008,,0.75,10423.034113728683,operating costs of operator1 + weeding
24/Jun/2008,381.17935179545464,,10804.213465524137,cropprice (bean)
24/Jun/2008,203.46920803551134,,11007.682673559648,cropprice (maize)
24/Jun/2008,57.05222944886364,,11064.734903008512,cropprice (maize_residue)
24/Jun/2008,,0.25,11064.484903008512,operating costs of operator1 + harvesting
25/Jun/2008,,0.25,11064.234903008512,operating costs of operator1 + harvesting
29/Jun/2008,,606.1,10458.134903008511,Farm Overheads
05/Jul/2008,0.0,,10458.134903008511,cropprice (maize)
05/Jul/2008,38.50435014204545,,10496.639253150557,cropprice (maize_residue)
05/Jul/2008,,0.75,10495.889253150557,operating costs of operator1 + harvesting
03/Aug/2008,,0.25,10495.639253150557,operating costs of operator1 + weeding
14/Aug/2008,,0.75,10494.889253150557,operating costs of operator1 + weeding
30/Aug/2008,,5.0,10489.889253150557,sowing costs
30/Aug/2008,,15.0,10474.889253150557,sowing costs
30/Aug/2008,,0.25,10474.639253150557,operating costs of operator1 + presow_till
31/Aug/2008,,0.25,10474.389253150557,operating costs of operator1 + sowing
01/Sep/2008,,0.75,10473.639253150557,operating costs of operator1 + presow_till
02/Sep/2008,,0.75,10472.889253150557,operating costs of operator1 + sowing
29/Sep/2008,,0.25,10472.639253150557,operating costs of operator1 + weeding
30/Sep/2008,,0.75,10471.889253150557,operating costs of operator1 + weeding
06/Dec/2008,327.28384808948863,,10799.173101240045,cropprice (maize)
06/Dec/2008,22.00934115340909,,10821.182442393454,cropprice (maize_residue)
06/Dec/2008,,0.25,10820.932442393454,operating costs of operator1 + harvesting
29/Dec/2008,0.0,,10820.932442393454,cropprice (maize)
29/Dec/2008,17.622667482954547,,10838.555109876408,cropprice (maize_residue)
29/Dec/2008,,0.75,10837.805109876408,operating costs of operator1 + harvesting
15/Jan/2009,,0.25,10837.555109876408,operating costs of operator1 + weeding
07/Feb/2009,,0.75,10836.805109876408,operating costs of operator1 + weeding
18/Mar/2009,,10.5,10826.305109876408,sowing costs
18/Mar/2009,,31.5,10794.805109876408,sowing costs
18/Mar/2009,,0.25,10794.555109876408,operating costs of operator1 + presow_till
19/Mar/2009,,0.25,10794.305109876408,operating costs of operator1 + sowing
20/Mar/2009,,0.75,10793.555109876408,operating costs of operator1 + presow_till
21/Mar/2009,,0.75,10792.805109876408,operating costs of operator1 + sowing
17/Apr/2009,,0.25,10792.555109876408,operating costs of operator1 + weeding
18/Apr/2009,,0.75,10791.805109876408,operating costs of operator1 + weeding
20/Jun/2009,69.30870855681816,,10861.113818433227,cropprice (bean)
20/Jun/2009,338.8943765369319,,11200.008194970158,cropprice (maize)
20/Jun/2009,32.16741665909091,,11232.175611629249,cropprice (maize_residue)
20/Jun/2009,,0.25,11231.925611629249,operating costs of operator1 + harvesting
21/Jun/2009,,0.25,11231.675611629249,operating costs of operator1 + harvesting
30/Jun/2009,0.0,,11231.675611629249,cropprice (maize)
30/Jun/2009,38.89312465909091,,11270.56873628834,cropprice (maize_residue)
30/Jun/2009,,0.75,11269.81873628834,operating costs of operator1 + harvesting
30/Jun/2009,,606.1,10663.71873628834,Farm Overheads
30/Jul/2009,,0.25,10663.46873628834,operating costs of operator1 + weeding
09/Aug/2009,,0.75,10662.71873628834,operating costs of operator1 + weeding
01/Sep/2009,,5.0,10657.71873628834,sowing costs
01/Sep/2009,,15.0,10642.71873628834,sowing costs
01/Sep/2009,,0.25,10642.46873628834,operating costs of operator1 + presow_till
02/Sep/2009,,0.25,10642.21873628834,operating costs of operator1 + sowing
03/Sep/2009,,0.75,10641.46873628834,operating costs of operator1 + presow_till
04/Sep/2009,,0.75,10640.71873628834,operating costs of operator1 + sowing
01/Oct/2009,,0.25,10640.46873628834,operating costs of operator1 + weeding
02/Oct/2009,,0.75,10639.71873628834,operating costs of operator1 + weeding
09/Dec/2009,93.12288852272727,,10732.841624811066,cropprice (maize)
09/Dec/2009,18.091927267045456,,10750.933552078111,cropprice (maize_residue)
09/Dec/2009,,0.25,10750.683552078111,operating costs of operator1 + harvesting
29/Dec/2009,0.0,,10750.683552078111,cropprice (maize)
29/Dec/2009,17.764162244318182,,10768.44771432243,cropprice (maize_residue)
29/Dec/2009,,0.75,10767.69771432243,operating costs of operator1 + harvesting
18/Jan/2010,,0.25,10767.44771432243,operating costs of operator1 + weeding
07/Feb/2010,,0.75,10766.69771432243,operating costs of operator1 + weeding
18/Mar/2010,,10.5,10756.19771432243,sowing costs
18/Mar/2010,,31.5,10724.69771432243,sowing costs
18/Mar/2010,,0.25,10724.44771432243,operating costs of operator1 + presow_till
19/Mar/2010,,0.25,10724.19771432243,operating costs of operator1 + sowing
20/Mar/2010,,0.75,10723.44771432243,operating costs of operator1 + presow_till
21/Mar/2010,,0.75,10722.69771432243,operating costs of operator1 + sowing
17/Apr/2010,,0.25,10722.44771432243,operating costs of operator1 + weeding
18/Apr/2010,,0.75,10721.69771432243,operating costs of operator1 + weeding
20/Jun/2010,94.00693133522726,,10815.704645657657,cropprice (bean)
20/Jun/2010,232.8537697414773,,11048.558415399135,cropprice (maize)
20/Jun/2010,29.174316409090906,,11077.732731808226,cropprice (maize_residue)
20/Jun/2010,,0.25,11077.482731808226,operating costs of operator1 + harvesting
21/Jun/2010,,0.25,11077.232731808226,operating costs of operator1 + harvesting
30/Jun/2010,,606.1,10471.132731808226,Farm Overheads
01/Jul/2010,0.0,,10471.132731808226,cropprice (maize)
01/Jul/2010,36.995968909090905,,10508.128700717316,cropprice (maize_residue)
01/Jul/2010,,0.75,10507.378700717316,operating costs of operator1 + harvesting
30/Jul/2010,,0.25,10507.128700717316,operating costs of operator1 + weeding
10/Aug/2010,,0.75,10506.378700717316,operating costs of operator1 + weeding
01/Sep/2010,,5.0,10501.378700717316,sowing costs
01/Sep/2010,,15.0,10486.378700717316,sowing costs
01/Sep/2010,,0.25,10486.128700717316,operating costs of operator1 + presow_till
02/Sep/2010,,0.25,10485.878700717316,operating costs of operator1 + sowing
03/Sep/2010,,0.75,10485.128700717316,operating costs of operator1 + presow_till
04/Sep/2010,,0.75,10484.378700717316,operating costs of operator1 + sowing
01/Oct/2010,,0.25,10484.128700717316,operating costs of operator1 + weeding
02/Oct/2010,,0.75,10483.378700717316,operating costs of operator1 + weeding
09/Dec/2010,69.79987943607954,,10553.178580153395,cropprice (maize)
09/Dec/2010,19.271151454545453,,10572.449731607941,cropprice (maize_residue)
09/Dec/2010,,0.25,10572.199731607941,operating costs of operator1 + harvesting
27/Dec/2010,0.0,,10572.199731607941,cropprice (maize)
27/Dec/2010,19.279466113636367,,10591.479197721577,cropprice (maize_residue)
27/Dec/2010,,0.75,10590.729197721577,operating costs of operator1 + harvesting
