date,income,expenditure,balance,comment
08/Sep/1979,,10.0,-10.0,sowing costs
08/Sep/1979,,10.0,-20.0,sowing costs
08/Sep/1979,,0.5,-20.5,operating costs of operator1 + presow_till
09/Sep/1979,,0.5,-21.0,operating costs of operator1 + sowing
10/Sep/1979,,0.5,-21.5,operating costs of operator1 + presow_till
11/Sep/1979,,0.5,-22.0,operating costs of operator1 + sowing
08/Oct/1979,,0.5,-22.5,operating costs of operator1 + weeding
09/Oct/1979,,0.5,-23.0,operating costs of operator1 + weeding
21/Dec/1979,0.0,,-23.0,cropprice (maize)
21/Dec/1979,30.62437022727273,,7.624370227272731,cropprice (maize_residue)
21/Dec/1979,0.0,,7.624370227272731,cropprice (maize)
21/Dec/1979,30.62437022727273,,38.24874045454546,cropprice (maize_residue)
21/Dec/1979,,0.5,37.74874045454546,operating costs of operator1 + harvesting
22/Dec/1979,,0.5,37.24874045454546,operating costs of operator1 + harvesting
30/Jan/1980,,0.5,36.74874045454546,operating costs of operator1 + weeding
31/Jan/1980,,0.5,36.24874045454546,operating costs of operator1 + weeding
08/Apr/1980,,21.0,15.248740454545462,sowing costs
08/Apr/1980,,21.0,-5.751259545454538,sowing costs
08/Apr/1980,,0.5,-6.251259545454538,operating costs of operator1 + presow_till
09/Apr/1980,,0.5,-6.751259545454538,operating costs of operator1 + sowing
10/Apr/1980,,0.5,-7.251259545454538,operating costs of operator1 + presow_till
11/Apr/1980,,0.5,-7.751259545454538,operating costs of operator1 + sowing
08/May/1980,,0.5,-8.251259545454538,operating costs of operator1 + weeding
09/May/1980,,0.5,-8.751259545454538,operating costs of operator1 + weeding
29/Jun/1980,,606.1,-614.8512595454546,Farm Overheads
18/Jul/1980,480.0664214659091,,-134.78483807954547,cropprice (maize)
18/Jul/1980,30.53583318181818,,-104.24900489772729,cropprice (maize_residue)
18/Jul/1980,,0.5,-104.74900489772729,operating costs of operator1 + harvesting
29/Jul/1980,1592.1777398863635,,1487.4287349886363,cropprice (bean)
29/Jul/1980,0.0,,1487.4287349886363,cropprice (maize)
29/Jul/1980,116.62982732954548,,1604.0585623181817,cropprice (maize_residue)
29/Jul/1980,,0.5,1603.5585623181817,operating costs of operator1 + harvesting
30/Jul/1980,,0.5,1603.0585623181817,operating costs of operator1 + harvesting
27/Aug/1980,,0.5,1602.5585623181817,operating costs of operator1 + weeding
31/Aug/1980,,10.0,1592.5585623181817,sowing costs
31/Aug/1980,,10.0,1582.5585623181817,sowing costs
31/Aug/1980,,0.5,1582.0585623181817,operating costs of operator1 + presow_till
01/Sep/1980,,0.5,1581.5585623181817,operating costs of operator1 + sowing
02/Sep/1980,,0.5,1581.0585623181817,operating costs of operator1 + presow_till
03/Sep/1980,,0.5,1580.5585623181817,operating costs of operator1 + sowing
07/Sep/1980,,0.5,1580.0585623181817,operating costs of operator1 + weeding
30/Sep/1980,,0.5,1579.5585623181817,operating costs of operator1 + weeding
01/Oct/1980,,0.5,1579.0585623181817,operating costs of operator1 + weeding
09/Dec/1980,486.9806412954545,,2066.0392036136363,cropprice (maize)
09/Dec/1980,35.154996,,2101.1941996136366,cropprice (maize_residue)
09/Dec/1980,,0.5,2100.6941996136366,operating costs of operator1 + harvesting
21/Dec/1980,0.0,,2100.6941996136366,cropprice (maize)
21/Dec/1980,30.191051136363637,,2130.88525075,cropprice (maize_residue)
21/Dec/1980,,0.5,2130.38525075,operating costs of operator1 + harvesting
18/Jan/1981,,0.5,2129.88525075,operating costs of operator1 + weeding
30/Jan/1981,,0.5,2129.38525075,operating costs of operator1 + weeding
15/Mar/1981,,21.0,2108.38525075,sowing costs
15/Mar/1981,,21.0,2087.38525075,sowing costs
15/Mar/1981,,0.5,2086.88525075,operating costs of operator1 + presow_till
16/Mar/1981,,0.5,2086.38525075,operating costs of operator1 + sowing
17/Mar/1981,,0.5,2085.88525075,operating costs of operator1 + presow_till
18/Mar/1981,,0.5,2085.38525075,operating costs of operator1 + sowing
14/Apr/1981,,0.5,2084.88525075,operating costs of operator1 + weeding
15/Apr/1981,,0.5,2084.38525075,operating costs of operator1 + weeding
25/Jun/1981,788.3382567613636,,2872.7235075113636,cropprice (bean)
25/Jun/1981,557.4392079545454,,3430.162715465909,cropprice (maize)
25/Jun/1981,96.44721013636364,,3526.6099256022726,cropprice (maize_residue)
25/Jun/1981,,0.5,3526.1099256022726,operating costs of operator1 + harvesting
26/Jun/1981,,0.5,3525.6099256022726,operating costs of operator1 + harvesting
30/Jun/1981,,606.1,2919.5099256022727,Farm Overheads
06/Jul/1981,0.0,,2919.5099256022727,cropprice (maize)
06/Jul/1981,28.61772294318182,,2948.1276485454546,cropprice (maize_residue)
06/Jul/1981,,0.5,2947.6276485454546,operating costs of operator1 + harvesting
04/Aug/1981,,0.5,2947.1276485454546,operating costs of operator1 + weeding
15/Aug/1981,,0.5,2946.6276485454546,operating costs of operator1 + weeding
01/Sep/1981,,10.0,2936.6276485454546,sowing costs
01/Sep/1981,,10.0,2926.6276485454546,sowing costs
01/Sep/1981,,0.5,2926.1276485454546,operating costs of operator1 + presow_till
02/Sep/1981,,0.5,2925.6276485454546,operating costs of operator1 + sowing
03/Sep/1981,,0.5,2925.1276485454546,operating costs of operator1 + presow_till
04/Sep/1981,,0.5,2924.6276485454546,operating costs of operator1 + sowing
01/Oct/1981,,0.5,2924.1276485454546,operating costs of operator1 + weeding
02/Oct/1981,,0.5,2923.6276485454546,operating costs of operator1 + weeding
11/Dec/1981,661.7685738664774,,3585.396222411932,cropprice (maize)
11/Dec/1981,54.12369052272727,,3639.5199129346593,cropprice (maize_residue)
11/Dec/1981,,0.5,3639.0199129346593,operating costs of operator1 + harvesting
27/Dec/1981,0.0,,3639.0199129346593,cropprice (maize)
27/Dec/1981,25.10633156818182,,3664.126244502841,cropprice (maize_residue)
27/Dec/1981,,0.5,3663.626244502841,operating costs of operator1 + harvesting
20/Jan/1982,,0.5,3663.126244502841,operating costs of operator1 + weeding
05/Feb/1982,,0.5,3662.626244502841,operating costs of operator1 + weeding
23/Mar/1982,,21.0,3641.626244502841,sowing costs
23/Mar/1982,,21.0,3620.626244502841,sowing costs
23/Mar/1982,,0.5,3620.126244502841,operating costs of operator1 + presow_till
24/Mar/1982,,0.5,3619.626244502841,operating costs of operator1 + sowing
25/Mar/1982,,0.5,3619.126244502841,operating costs of operator1 + presow_till
26/Mar/1982,,0.5,3618.626244502841,operating costs of operator1 + sowing
22/Apr/1982,,0.5,3618.126244502841,operating costs of operator1 + weeding
23/Apr/1982,,0.5,3617.626244502841,operating costs of operator1 + weeding
30/Jun/1982,,606.1,3011.526244502841,Farm Overheads
01/Jul/1982,302.8201944886364,,3314.3464389914775,cropprice (bean)
01/Jul/1982,700.0993468636364,,4014.445785855114,cropprice (maize)
01/Jul/1982,83.05663507954547,,4097.502420934659,cropprice (maize_residue)
01/Jul/1982,439.58176679829546,,4537.084187732955,cropprice (maize)
01/Jul/1982,28.53328080681818,,4565.617468539773,cropprice (maize_residue)
01/Jul/1982,,0.5,4565.117468539773,operating costs of operator1 + harvesting
02/Jul/1982,,0.5,4564.617468539773,operating costs of operator1 + harvesting
03/Jul/1982,,0.5,4564.117468539773,operating costs of operator1 + harvesting
10/Aug/1982,,0.5,4563.617468539773,operating costs of operator1 + weeding
11/Aug/1982,,0.5,4563.117468539773,operating costs of operator1 + weeding
08/Sep/1982,,10.0,4553.117468539773,sowing costs
08/Sep/1982,,10.0,4543.117468539773,sowing costs
08/Sep/1982,,0.5,4542.617468539773,operating costs of operator1 + presow_till
09/Sep/1982,,0.5,4542.117468539773,operating costs of operator1 + sowing
10/Sep/1982,,0.5,4541.617468539773,operating costs of operator1 + presow_till
11/Sep/1982,,0.5,4541.117468539773,operating costs of operator1 + sowing
08/Oct/1982,,0.5,4540.617468539773,operating costs of operator1 + weeding
09/Oct/1982,,0.5,4540.117468539773,operating costs of operator1 + weeding
20/Dec/1982,523.1225398039774,,5063.24000834375,cropprice (maize)
20/Dec/1982,40.41887318181818,,5103.658881525568,cropprice (maize_residue)
20/Dec/1982,,0.5,5103.158881525568,operating costs of operator1 + harvesting
24/Dec/1982,0.0,,5103.158881525568,cropprice (maize)
24/Dec/1982,40.16507789772728,,5143.3239594232955,cropprice (maize_residue)
24/Dec/1982,,0.5,5142.8239594232955,operating costs of operator1 + harvesting
29/Jan/1983,,0.5,5142.3239594232955,operating costs of operator1 + weeding
02/Feb/1983,,0.5,5141.8239594232955,operating costs of operator1 + weeding
16/Mar/1983,,21.0,5120.8239594232955,sowing costs
16/Mar/1983,,21.0,5099.8239594232955,sowing costs
16/Mar/1983,,0.5,5099.3239594232955,operating costs of operator1 + presow_till
17/Mar/1983,,0.5,5098.8239594232955,operating costs of operator1 + sowing
18/Mar/1983,,0.5,5098.3239594232955,operating costs of operator1 + presow_till
19/Mar/1983,,0.5,5097.8239594232955,operating costs of operator1 + sowing
15/Apr/1983,,0.5,5097.3239594232955,operating costs of operator1 + weeding
16/Apr/1983,,0.5,5096.8239594232955,operating costs of operator1 + weeding
18/Jun/1983,213.17776414772726,,5310.001723571023,cropprice (bean)
18/Jun/1983,595.4142447613636,,5905.415968332387,cropprice (maize)
18/Jun/1983,69.39721679545455,,5974.813185127841,cropprice (maize_residue)
18/Jun/1983,,0.5,5974.313185127841,operating costs of operator1 + harvesting
19/Jun/1983,,0.5,5973.813185127841,operating costs of operator1 + harvesting
26/Jun/1983,0.0,,5973.813185127841,cropprice (maize)
26/Jun/1983,30.472506431818186,,6004.285691559659,cropprice (maize_residue)
26/Jun/1983,,0.5,6003.785691559659,operating costs of operator1 + harvesting
30/Jun/1983,,606.1,5397.685691559659,Farm Overheads
28/Jul/1983,,0.5,5397.185691559659,operating costs of operator1 + weeding
05/Aug/1983,,0.5,5396.685691559659,operating costs of operator1 + weeding
01/Sep/1983,,10.0,5386.685691559659,sowing costs
01/Sep/1983,,10.0,5376.685691559659,sowing costs
01/Sep/1983,,0.5,5376.185691559659,operating costs of operator1 + presow_till
02/Sep/1983,,0.5,5375.685691559659,operating costs of operator1 + sowing
03/Sep/1983,,0.5,5375.185691559659,operating costs of operator1 + presow_till
04/Sep/1983,,0.5,5374.685691559659,operating costs of operator1 + sowing
01/Oct/1983,,0.5,5374.185691559659,operating costs of operator1 + weeding
02/Oct/1983,,0.5,5373.685691559659,operating costs of operator1 + weeding
12/Dec/1983,463.9463402045455,,5837.632031764205,cropprice (maize)
12/Dec/1983,34.20621560227272,,5871.838247366478,cropprice (maize_residue)
12/Dec/1983,,0.5,5871.338247366478,operating costs of operator1 + harvesting
28/Dec/1983,0.0,,5871.338247366478,cropprice (maize)
28/Dec/1983,24.82306740909091,,5896.161314775569,cropprice (maize_residue)
28/Dec/1983,,0.5,5895.661314775569,operating costs of operator1 + harvesting
21/Jan/1984,,0.5,5895.161314775569,operating costs of operator1 + weeding
06/Feb/1984,,0.5,5894.661314775569,operating costs of operator1 + weeding
14/Mar/1984,,21.0,5873.661314775569,sowing costs
14/Mar/1984,,21.0,5852.661314775569,sowing costs
14/Mar/1984,,0.5,5852.161314775569,operating costs of operator1 + presow_till
15/Mar/1984,,0.5,5851.661314775569,operating costs of operator1 + sowing
16/Mar/1984,,0.5,5851.161314775569,operating costs of operator1 + presow_till
17/Mar/1984,,0.5,5850.661314775569,operating costs of operator1 + sowing
13/Apr/1984,,0.5,5850.161314775569,operating costs of operator1 + weeding
14/Apr/1984,,0.5,5849.661314775569,operating costs of operator1 + weeding
18/Jun/1984,183.97823682954544,,6033.639551605114,cropprice (bean)
18/Jun/1984,656.6794788153409,,6690.319030420455,cropprice (maize)
18/Jun/1984,63.41573819318182,,6753.734768613637,cropprice (maize_residue)
18/Jun/1984,,0.5,6753.234768613637,operating costs of operator1 + harvesting
19/Jun/1984,,0.5,6752.734768613637,operating costs of operator1 + harvesting
20/Jun/1984,260.2179237784091,,7012.952692392047,cropprice (maize)
20/Jun/1984,31.750366215909093,,7044.703058607955,cropprice (maize_residue)
20/Jun/1984,,0.5,7044.203058607955,operating costs of operator1 + harvesting
29/Jun/1984,,606.1,6438.103058607955,Farm Overheads
28/Jul/1984,,0.5,6437.603058607955,operating costs of operator1 + weeding
30/Jul/1984,,0.5,6437.103058607955,operating costs of operator1 + weeding
30/Aug/1984,,10.0,6427.103058607955,sowing costs
30/Aug/1984,,10.0,6417.103058607955,sowing costs
30/Aug/1984,,0.5,6416.603058607955,operating costs of operator1 + presow_till
31/Aug/1984,,0.5,6416.103058607955,operating costs of operator1 + sowing
01/Sep/1984,,0.5,6415.603058607955,operating costs of operator1 + presow_till
02/Sep/1984,,0.5,6415.103058607955,operating costs of operator1 + sowing
29/Sep/1984,,0.5,6414.603058607955,operating costs of operator1 + weeding
30/Sep/1984,,0.5,6414.103058607955,operating costs of operator1 + weeding
09/Dec/1984,348.98223167897737,,6763.085290286933,cropprice (maize)
09/Dec/1984,32.012367943181815,,6795.097658230115,cropprice (maize_residue)
09/Dec/1984,,0.5,6794.597658230115,operating costs of operator1 + harvesting
10/Dec/1984,151.19037529261365,,6945.788033522728,cropprice (maize)
10/Dec/1984,37.782958988636366,,6983.570992511364,cropprice (maize_residue)
10/Dec/1984,,0.5,6983.070992511364,operating costs of operator1 + harvesting
18/Jan/1985,,0.5,6982.570992511364,operating costs of operator1 + weeding
19/Jan/1985,,0.5,6982.070992511364,operating costs of operator1 + weeding
20/Mar/1985,,21.0,6961.070992511364,sowing costs
20/Mar/1985,,21.0,6940.070992511364,sowing costs
20/Mar/1985,,0.5,6939.570992511364,operating costs of operator1 + presow_till
21/Mar/1985,,0.5,6939.070992511364,operating costs of operator1 + sowing
22/Mar/1985,,0.5,6938.570992511364,operating costs of operator1 + presow_till
23/Mar/1985,,0.5,6938.070992511364,operating costs of operator1 + sowing
19/Apr/1985,,0.5,6937.570992511364,operating costs of operator1 + weeding
20/Apr/1985,,0.5,6937.070992511364,operating costs of operator1 + weeding
30/Jun/1985,,606.1,6330.970992511364,Farm Overheads
05/Jul/1985,1475.8256169204546,,7806.796609431818,cropprice (bean)
05/Jul/1985,0.0,,7806.796609431818,cropprice (maize)
05/Jul/1985,127.90818093181815,,7934.704790363636,cropprice (maize_residue)
05/Jul/1985,0.0,,7934.704790363636,cropprice (maize)
05/Jul/1985,38.182123352272725,,7972.886913715908,cropprice (maize_residue)
05/Jul/1985,,0.5,7972.386913715908,operating costs of operator1 + harvesting
06/Jul/1985,,0.5,7971.886913715908,operating costs of operator1 + harvesting
07/Jul/1985,,0.5,7971.386913715908,operating costs of operator1 + harvesting
14/Aug/1985,,0.5,7970.886913715908,operating costs of operator1 + weeding
15/Aug/1985,,0.5,7970.386913715908,operating costs of operator1 + weeding
01/Sep/1985,,10.0,7960.386913715908,sowing costs
01/Sep/1985,,10.0,7950.386913715908,sowing costs
01/Sep/1985,,0.5,7949.886913715908,operating costs of operator1 + presow_till
02/Sep/1985,,0.5,7949.386913715908,operating costs of operator1 + sowing
03/Sep/1985,,0.5,7948.886913715908,operating costs of operator1 + presow_till
04/Sep/1985,,0.5,7948.386913715908,operating costs of operator1 + sowing
01/Oct/1985,,0.5,7947.886913715908,operating costs of operator1 + weeding
02/Oct/1985,,0.5,7947.386913715908,operating costs of operator1 + weeding
13/Dec/1985,23.840227977272725,,7971.227141693181,cropprice (maize)
13/Dec/1985,40.612809613636365,,8011.839951306817,cropprice (maize_residue)
13/Dec/1985,,0.5,8011.339951306817,operating costs of operator1 + harvesting
29/Dec/1985,0.0,,8011.339951306817,cropprice (maize)
29/Dec/1985,12.898215556818185,,8024.238166863635,cropprice (maize_residue)
29/Dec/1985,,0.5,8023.738166863635,operating costs of operator1 + harvesting
22/Jan/1986,,0.5,8023.238166863635,operating costs of operator1 + weeding
07/Feb/1986,,0.5,8022.738166863635,operating costs of operator1 + weeding
21/Mar/1986,,21.0,8001.738166863635,sowing costs
21/Mar/1986,,21.0,7980.738166863635,sowing costs
21/Mar/1986,,0.5,7980.238166863635,operating costs of operator1 + presow_till
22/Mar/1986,,0.5,7979.738166863635,operating costs of operator1 + sowing
23/Mar/1986,,0.5,7979.238166863635,operating costs of operator1 + presow_till
24/Mar/1986,,0.5,7978.738166863635,operating costs of operator1 + sowing
20/Apr/1986,,0.5,7978.238166863635,operating costs of operator1 + weeding
21/Apr/1986,,0.5,7977.738166863635,operating costs of operator1 + weeding
30/Jun/1986,,606.1,7371.638166863635,Farm Overheads
01/Jul/1986,634.8004012159092,,8006.438568079544,cropprice (bean)
01/Jul/1986,534.6734827670455,,8541.11205084659,cropprice (maize)
01/Jul/1986,88.34025989772728,,8629.452310744318,cropprice (maize_residue)
01/Jul/1986,,0.5,8628.952310744318,operating costs of operator1 + harvesting
02/Jul/1986,220.80745014204544,,8849.759760886363,cropprice (maize)
02/Jul/1986,35.73587313636364,,8885.495634022727,cropprice (maize_residue)
02/Jul/1986,,0.5,8884.995634022727,operating costs of operator1 + harvesting
03/Jul/1986,,0.5,8884.495634022727,operating costs of operator1 + harvesting
10/Aug/1986,,0.5,8883.995634022727,operating costs of operator1 + weeding
11/Aug/1986,,0.5,8883.495634022727,operating costs of operator1 + weeding
02/Sep/1986,,10.0,8873.495634022727,sowing costs
02/Sep/1986,,10.0,8863.495634022727,sowing costs
02/Sep/1986,,0.5,8862.995634022727,operating costs of operator1 + presow_till
03/Sep/1986,,0.5,8862.495634022727,operating costs of operator1 + sowing
04/Sep/1986,,0.5,8861.995634022727,operating costs of operator1 + presow_till
05/Sep/1986,,0.5,8861.495634022727,operating costs of operator1 + sowing
02/Oct/1986,,0.5,8860.995634022727,operating costs of operator1 + weeding
03/Oct/1986,,0.5,8860.495634022727,operating costs of operator1 + weeding
11/Dec/1986,689.1235625625,,9549.619196585227,cropprice (maize)
11/Dec/1986,54.45070578409091,,9604.069902369318,cropprice (maize_residue)
11/Dec/1986,,0.5,9603.569902369318,operating costs of operator1 + harvesting
18/Dec/1986,0.0,,9603.569902369318,cropprice (maize)
18/Dec/1986,35.86476273863636,,9639.434665107954,cropprice (maize_residue)
18/Dec/1986,,0.5,9638.934665107954,operating costs of operator1 + harvesting
20/Jan/1987,,0.5,9638.434665107954,operating costs of operator1 + weeding
27/Jan/1987,,0.5,9637.934665107954,operating costs of operator1 + weeding
16/Mar/1987,,21.0,9616.934665107954,sowing costs
16/Mar/1987,,21.0,9595.934665107954,sowing costs
16/Mar/1987,,0.5,9595.434665107954,operating costs of operator1 + presow_till
17/Mar/1987,,0.5,9594.934665107954,operating costs of operator1 + sowing
18/Mar/1987,,0.5,9594.434665107954,operating costs of operator1 + presow_till
19/Mar/1987,,0.5,9593.934665107954,operating costs of operator1 + sowing
15/Apr/1987,,0.5,9593.434665107954,operating costs of operator1 + weeding
16/Apr/1987,,0.5,9592.934665107954,operating costs of operator1 + weeding
22/Jun/1987,446.09855086363643,,10039.03321597159,cropprice (bean)
22/Jun/1987,530.5253283323864,,10569.558544303978,cropprice (maize)
22/Jun/1987,84.17109263636364,,10653.729636940341,cropprice (maize_residue)
22/Jun/1987,,0.5,10653.229636940341,operating costs of operator1 + harvesting
23/Jun/1987,,0.5,10652.729636940341,operating costs of operator1 + harvesting
30/Jun/1987,,606.1,10046.62963694034,Farm Overheads
06/Jul/1987,0.0,,10046.62963694034,cropprice (maize)
06/Jul/1987,28.993463693181813,,10075.623100633522,cropprice (maize_residue)
06/Jul/1987,,0.5,10075.123100633522,operating costs of operator1 + harvesting
01/Aug/1987,,0.5,10074.623100633522,operating costs of operator1 + weeding
15/Aug/1987,,0.5,10074.123100633522,operating costs of operator1 + weeding
09/Sep/1987,,10.0,10064.123100633522,sowing costs
09/Sep/1987,,10.0,10054.123100633522,sowing costs
09/Sep/1987,,0.5,10053.623100633522,operating costs of operator1 + presow_till
10/Sep/1987,,0.5,10053.123100633522,operating costs of operator1 + sowing
11/Sep/1987,,0.5,10052.623100633522,operating costs of operator1 + presow_till
12/Sep/1987,,0.5,10052.123100633522,operating costs of operator1 + sowing
09/Oct/1987,,0.5,10051.623100633522,operating costs of operator1 + weeding
10/Oct/1987,,0.5,10051.123100633522,operating costs of operator1 + weeding
17/Dec/1987,718.5499139318182,,10769.67301456534,cropprice (maize)
17/Dec/1987,65.19325395454545,,10834.866268519885,cropprice (maize_residue)
17/Dec/1987,,0.5,10834.366268519885,operating costs of operator1 + harvesting
30/Dec/1987,0.0,,10834.366268519885,cropprice (maize)
30/Dec/1987,28.779696374999997,,10863.145964894886,cropprice (maize_residue)
30/Dec/1987,,0.5,10862.645964894886,operating costs of operator1 + harvesting
26/Jan/1988,,0.5,10862.145964894886,operating costs of operator1 + weeding
08/Feb/1988,,0.5,10861.645964894886,operating costs of operator1 + weeding
17/Mar/1988,,21.0,10840.645964894886,sowing costs
17/Mar/1988,,21.0,10819.645964894886,sowing costs
17/Mar/1988,,0.5,10819.145964894886,operating costs of operator1 + presow_till
18/Mar/1988,,0.5,10818.645964894886,operating costs of operator1 + sowing
19/Mar/1988,,0.5,10818.145964894886,operating costs of operator1 + presow_till
20/Mar/1988,,0.5,10817.645964894886,operating costs of operator1 + sowing
16/Apr/1988,,0.5,10817.145964894886,operating costs of operator1 + weeding
17/Apr/1988,,0.5,10816.645964894886,operating costs of operator1 + weeding
26/Jun/1988,1166.8071399886364,,11983.453104883522,cropprice (bean)
26/Jun/1988,256.132300125,,12239.585405008522,cropprice (maize)
26/Jun/1988,137.3111239318182,,12376.89652894034,cropprice (maize_residue)
26/Jun/1988,,0.5,12376.39652894034,operating costs of operator1 + harvesting
27/Jun/1988,,0.5,12375.89652894034,operating costs of operator1 + harvesting
29/Jun/1988,,606.1,11769.79652894034,Farm Overheads
08/Jul/1988,0.0,,11769.79652894034,cropprice (maize)
08/Jul/1988,29.64016446590909,,11799.43669340625,cropprice (maize_residue)
08/Jul/1988,,0.5,11798.93669340625,operating costs of operator1 + harvesting
05/Aug/1988,,0.5,11798.43669340625,operating costs of operator1 + weeding
17/Aug/1988,,0.5,11797.93669340625,operating costs of operator1 + weeding
30/Aug/1988,,10.0,11787.93669340625,sowing costs
30/Aug/1988,,10.0,11777.93669340625,sowing costs
30/Aug/1988,,0.5,11777.43669340625,operating costs of operator1 + presow_till
31/Aug/1988,,0.5,11776.93669340625,operating costs of operator1 + sowing
01/Sep/1988,,0.5,11776.43669340625,operating costs of operator1 + presow_till
02/Sep/1988,,0.5,11775.93669340625,operating costs of operator1 + sowing
29/Sep/1988,,0.5,11775.43669340625,operating costs of operator1 + weeding
30/Sep/1988,,0.5,11774.93669340625,operating costs of operator1 + weeding
11/Dec/1988,716.0156652698862,,12490.952358676135,cropprice (maize)
11/Dec/1988,62.106295499999995,,12553.058654176135,cropprice (maize_residue)
11/Dec/1988,,0.5,12552.558654176135,operating costs of operator1 + harvesting
01/Jan/1989,0.0,,12552.558654176135,cropprice (maize)
01/Jan/1989,19.806304931818183,,12572.364959107954,cropprice (maize_residue)
01/Jan/1989,,0.5,12571.864959107954,operating costs of operator1 + harvesting
20/Jan/1989,,0.5,12571.364959107954,operating costs of operator1 + weeding
10/Feb/1989,,0.5,12570.864959107954,operating costs of operator1 + weeding
15/Mar/1989,,21.0,12549.864959107954,sowing costs
15/Mar/1989,,21.0,12528.864959107954,sowing costs
15/Mar/1989,,0.5,12528.364959107954,operating costs of operator1 + presow_till
16/Mar/1989,,0.5,12527.864959107954,operating costs of operator1 + sowing
17/Mar/1989,,0.5,12527.364959107954,operating costs of operator1 + presow_till
18/Mar/1989,,0.5,12526.864959107954,operating costs of operator1 + sowing
14/Apr/1989,,0.5,12526.364959107954,operating costs of operator1 + weeding
15/Apr/1989,,0.5,12525.864959107954,operating costs of operator1 + weeding
27/Jun/1989,831.247883215909,,13357.112842323862,cropprice (bean)
27/Jun/1989,420.15876580397725,,13777.27160812784,cropprice (maize)
27/Jun/1989,99.89557439772726,,13877.167182525567,cropprice (maize_residue)
27/Jun/1989,,0.5,13876.667182525567,operating costs of operator1 + harvesting
28/Jun/1989,,0.5,13876.167182525567,operating costs of operator1 + harvesting
30/Jun/1989,,606.1,13270.067182525567,Farm Overheads
13/Jul/1989,0.0,,13270.067182525567,cropprice (maize)
13/Jul/1989,25.52763782954546,,13295.594820355112,cropprice (maize_residue)
13/Jul/1989,,0.5,13295.094820355112,operating costs of operator1 + harvesting
06/Aug/1989,,0.5,13294.594820355112,operating costs of operator1 + weeding
22/Aug/1989,,0.5,13294.094820355112,operating costs of operator1 + weeding
01/Sep/1989,,10.0,13284.094820355112,sowing costs
01/Sep/1989,,10.0,13274.094820355112,sowing costs
01/Sep/1989,,0.5,13273.594820355112,operating costs of operator1 + presow_till
02/Sep/1989,,0.5,13273.094820355112,operating costs of operator1 + sowing
03/Sep/1989,,0.5,13272.594820355112,operating costs of operator1 + presow_till
04/Sep/1989,,0.5,13272.094820355112,operating costs of operator1 + sowing
01/Oct/1989,,0.5,13271.594820355112,operating costs of operator1 + weeding
02/Oct/1989,,0.5,13271.094820355112,operating costs of operator1 + weeding
11/Dec/1989,663.2738280852274,,13934.36864844034,cropprice (maize)
11/Dec/1989,53.72020929545454,,13988.088857735795,cropprice (maize_residue)
11/Dec/1989,,0.5,13987.588857735795,operating costs of operator1 + harvesting
30/Dec/1989,0.0,,13987.588857735795,cropprice (maize)
30/Dec/1989,19.777757125,,14007.366614860795,cropprice (maize_residue)
30/Dec/1989,,0.5,14006.866614860795,operating costs of operator1 + harvesting
20/Jan/1990,,0.5,14006.366614860795,operating costs of operator1 + weeding
08/Feb/1990,,0.5,14005.866614860795,operating costs of operator1 + weeding
15/Mar/1990,,21.0,13984.866614860795,sowing costs
15/Mar/1990,,21.0,13963.866614860795,sowing costs
15/Mar/1990,,0.5,13963.366614860795,operating costs of operator1 + presow_till
16/Mar/1990,,0.5,13962.866614860795,operating costs of operator1 + sowing
17/Mar/1990,,0.5,13962.366614860795,operating costs of operator1 + presow_till
18/Mar/1990,,0.5,13961.866614860795,operating costs of operator1 + sowing
14/Apr/1990,,0.5,13961.366614860795,operating costs of operator1 + weeding
15/Apr/1990,,0.5,13960.866614860795,operating costs of operator1 + weeding
24/Jun/1990,574.780326034091,,14535.646940894887,cropprice (bean)
24/Jun/1990,531.8130182471592,,15067.459959142047,cropprice (maize)
24/Jun/1990,84.92732931818182,,15152.387288460228,cropprice (maize_residue)
24/Jun/1990,,0.5,15151.887288460228,operating costs of operator1 + harvesting
25/Jun/1990,,0.5,15151.387288460228,operating costs of operator1 + harvesting
30/Jun/1990,,606.1,14545.287288460228,Farm Overheads
05/Jul/1990,0.0,,14545.287288460228,cropprice (maize)
05/Jul/1990,26.739407625000005,,14572.026696085228,cropprice (maize_residue)
05/Jul/1990,,0.5,14571.526696085228,operating costs of operator1 + harvesting
03/Aug/1990,,0.5,14571.026696085228,operating costs of operator1 + weeding
14/Aug/1990,,0.5,14570.526696085228,operating costs of operator1 + weeding
01/Sep/1990,,10.0,14560.526696085228,sowing costs
01/Sep/1990,,10.0,14550.526696085228,sowing costs
01/Sep/1990,,0.5,14550.026696085228,operating costs of operator1 + presow_till
02/Sep/1990,,0.5,14549.526696085228,operating costs of operator1 + sowing
03/Sep/1990,,0.5,14549.026696085228,operating costs of operator1 + presow_till
04/Sep/1990,,0.5,14548.526696085228,operating costs of operator1 + sowing
01/Oct/1990,,0.5,14548.026696085228,operating costs of operator1 + weeding
02/Oct/1990,,0.5,14547.526696085228,operating costs of operator1 + weeding
14/Dec/1990,582.5282612386363,,15130.054957323864,cropprice (maize)
14/Dec/1990,46.84625798863636,,15176.9012153125,cropprice (maize_residue)
14/Dec/1990,,0.5,15176.4012153125,operating costs of operator1 + harvesting
02/Jan/1991,0.0,,15176.4012153125,cropprice (maize)
02/Jan/1991,23.752913045454545,,15200.154128357955,cropprice (maize_residue)
02/Jan/1991,,0.5,15199.654128357955,operating costs of operator1 + harvesting
23/Jan/1991,,0.5,15199.154128357955,operating costs of operator1 + weeding
11/Feb/1991,,0.5,15198.654128357955,operating costs of operator1 + weeding
27/Mar/1991,,21.0,15177.654128357955,sowing costs
27/Mar/1991,,21.0,15156.654128357955,sowing costs
27/Mar/1991,,0.5,15156.154128357955,operating costs of operator1 + presow_till
28/Mar/1991,,0.5,15155.654128357955,operating costs of operator1 + sowing
29/Mar/1991,,0.5,15155.154128357955,operating costs of operator1 + presow_till
30/Mar/1991,,0.5,15154.654128357955,operating costs of operator1 + sowing
26/Apr/1991,,0.5,15154.154128357955,operating costs of operator1 + weeding
27/Apr/1991,,0.5,15153.654128357955,operating costs of operator1 + weeding
30/Jun/1991,,606.1,14547.554128357955,Farm Overheads
06/Jul/1991,642.1516363977272,,15189.705764755683,cropprice (bean)
06/Jul/1991,530.9983099602273,,15720.70407471591,cropprice (maize)
06/Jul/1991,88.03250399999999,,15808.73657871591,cropprice (maize_residue)
06/Jul/1991,,0.5,15808.23657871591,operating costs of operator1 + harvesting
07/Jul/1991,,0.5,15807.73657871591,operating costs of operator1 + harvesting
13/Jul/1991,0.0,,15807.73657871591,cropprice (maize)
13/Jul/1991,30.34874378409091,,15838.085322500001,cropprice (maize_residue)
13/Jul/1991,,0.5,15837.585322500001,operating costs of operator1 + harvesting
15/Aug/1991,,0.5,15837.085322500001,operating costs of operator1 + weeding
22/Aug/1991,,0.5,15836.585322500001,operating costs of operator1 + weeding
02/Sep/1991,,10.0,15826.585322500001,sowing costs
02/Sep/1991,,10.0,15816.585322500001,sowing costs
02/Sep/1991,,0.5,15816.085322500001,operating costs of operator1 + presow_till
03/Sep/1991,,0.5,15815.585322500001,operating costs of operator1 + sowing
04/Sep/1991,,0.5,15815.085322500001,operating costs of operator1 + presow_till
05/Sep/1991,,0.5,15814.585322500001,operating costs of operator1 + sowing
02/Oct/1991,,0.5,15814.085322500001,operating costs of operator1 + weeding
03/Oct/1991,,0.5,15813.585322500001,operating costs of operator1 + weeding
13/Dec/1991,625.6533079602273,,16439.23863046023,cropprice (maize)
13/Dec/1991,43.80425470454546,,16483.042885164774,cropprice (maize_residue)
13/Dec/1991,,0.5,16482.542885164774,operating costs of operator1 + harvesting
02/Jan/1992,0.0,,16482.542885164774,cropprice (maize)
02/Jan/1992,18.68788285227273,,16501.230768017045,cropprice (maize_residue)
02/Jan/1992,,0.5,16500.730768017045,operating costs of operator1 + harvesting
22/Jan/1992,,0.5,16500.230768017045,operating costs of operator1 + weeding
11/Feb/1992,,0.5,16499.730768017045,operating costs of operator1 + weeding
01/Apr/1992,,21.0,16478.730768017045,sowing costs
01/Apr/1992,,21.0,16457.730768017045,sowing costs
01/Apr/1992,,0.5,16457.230768017045,operating costs of operator1 + presow_till
02/Apr/1992,,0.5,16456.730768017045,operating costs of operator1 + sowing
03/Apr/1992,,0.5,16456.230768017045,operating costs of operator1 + presow_till
04/Apr/1992,,0.5,16455.730768017045,operating costs of operator1 + sowing
01/May/1992,,0.5,16455.230768017045,operating costs of operator1 + weeding
02/May/1992,,0.5,16454.730768017045,operating costs of operator1 + weeding
29/Jun/1992,,606.1,15848.630768017045,Farm Overheads
11/Jul/1992,590.6018704090909,,16439.232638426136,cropprice (bean)
11/Jul/1992,634.1542678806818,,17073.38690630682,cropprice (maize)
11/Jul/1992,92.18207342045453,,17165.568979727275,cropprice (maize_residue)
11/Jul/1992,,0.5,17165.068979727275,operating costs of operator1 + harvesting
12/Jul/1992,186.43946077840909,,17351.508440505684,cropprice (maize)
12/Jul/1992,34.77338201136364,,17386.28182251705,cropprice (maize_residue)
12/Jul/1992,,0.5,17385.78182251705,operating costs of operator1 + harvesting
13/Jul/1992,,0.5,17385.28182251705,operating costs of operator1 + harvesting
20/Aug/1992,,0.5,17384.78182251705,operating costs of operator1 + weeding
21/Aug/1992,,0.5,17384.28182251705,operating costs of operator1 + weeding
31/Aug/1992,,10.0,17374.28182251705,sowing costs
31/Aug/1992,,10.0,17364.28182251705,sowing costs
31/Aug/1992,,0.5,17363.78182251705,operating costs of operator1 + presow_till
01/Sep/1992,,0.5,17363.28182251705,operating costs of operator1 + sowing
02/Sep/1992,,0.5,17362.78182251705,operating costs of operator1 + presow_till
03/Sep/1992,,0.5,17362.28182251705,operating costs of operator1 + sowing
30/Sep/1992,,0.5,17361.78182251705,operating costs of operator1 + weeding
01/Oct/1992,,0.5,17361.28182251705,operating costs of operator1 + weeding
13/Dec/1992,513.2805823380683,,17874.562404855118,cropprice (maize)
13/Dec/1992,37.75899436363636,,17912.321399218756,cropprice (maize_residue)
13/Dec/1992,,0.5,17911.821399218756,operating costs of operator1 + harvesting
30/Dec/1992,0.0,,17911.821399218756,cropprice (maize)
30/Dec/1992,27.538033227272724,,17939.35943244603,cropprice (maize_residue)
30/Dec/1992,,0.5,17938.85943244603,operating costs of operator1 + harvesting
22/Jan/1993,,0.5,17938.35943244603,operating costs of operator1 + weeding
08/Feb/1993,,0.5,17937.85943244603,operating costs of operator1 + weeding
15/Mar/1993,,21.0,17916.85943244603,sowing costs
15/Mar/1993,,21.0,17895.85943244603,sowing costs
15/Mar/1993,,0.5,17895.35943244603,operating costs of operator1 + presow_till
16/Mar/1993,,0.5,17894.85943244603,operating costs of operator1 + sowing
17/Mar/1993,,0.5,17894.35943244603,operating costs of operator1 + presow_till
18/Mar/1993,,0.5,17893.85943244603,operating costs of operator1 + sowing
14/Apr/1993,,0.5,17893.35943244603,operating costs of operator1 + weeding
15/Apr/1993,,0.5,17892.85943244603,operating costs of operator1 + weeding
20/Jun/1993,599.3747862613637,,18492.234218707392,cropprice (bean)
20/Jun/1993,421.9517020994318,,18914.185920806824,cropprice (maize)
20/Jun/1993,107.06594015909091,,19021.251860965913,cropprice (maize_residue)
20/Jun/1993,,0.5,19020.751860965913,operating costs of operator1 + harvesting
21/Jun/1993,,0.5,19020.251860965913,operating costs of operator1 + harvesting
30/Jun/1993,,606.1,18414.151860965914,Farm Overheads
04/Jul/1993,0.0,,18414.151860965914,cropprice (maize)
04/Jul/1993,26.778325863636358,,18440.93018682955,cropprice (maize_residue)
04/Jul/1993,,0.5,18440.43018682955,operating costs of operator1 + harvesting
30/Jul/1993,,0.5,18439.93018682955,operating costs of operator1 + weeding
13/Aug/1993,,0.5,18439.43018682955,operating costs of operator1 + weeding
05/Sep/1993,,10.0,18429.43018682955,sowing costs
05/Sep/1993,,10.0,18419.43018682955,sowing costs
05/Sep/1993,,0.5,18418.93018682955,operating costs of operator1 + presow_till
06/Sep/1993,,0.5,18418.43018682955,operating costs of operator1 + sowing
07/Sep/1993,,0.5,18417.93018682955,operating costs of operator1 + presow_till
08/Sep/1993,,0.5,18417.43018682955,operating costs of operator1 + sowing
05/Oct/1993,,0.5,18416.93018682955,operating costs of operator1 + weeding
06/Oct/1993,,0.5,18416.43018682955,operating costs of operator1 + weeding
13/Dec/1993,691.5469731051136,,19107.977159934664,cropprice (maize)
13/Dec/1993,54.197015931818186,,19162.174175866483,cropprice (maize_residue)
13/Dec/1993,,0.5,19161.674175866483,operating costs of operator1 + harvesting
31/Dec/1993,0.0,,19161.674175866483,cropprice (maize)
31/Dec/1993,20.857161090909095,,19182.531336957392,cropprice (maize_residue)
31/Dec/1993,,0.5,19182.031336957392,operating costs of operator1 + harvesting
22/Jan/1994,,0.5,19181.531336957392,operating costs of operator1 + weeding
09/Feb/1994,,0.5,19181.031336957392,operating costs of operator1 + weeding
18/Mar/1994,,21.0,19160.031336957392,sowing costs
18/Mar/1994,,21.0,19139.031336957392,sowing costs
18/Mar/1994,,0.5,19138.531336957392,operating costs of operator1 + presow_till
19/Mar/1994,,0.5,19138.031336957392,operating costs of operator1 + sowing
20/Mar/1994,,0.5,19137.531336957392,operating costs of operator1 + presow_till
21/Mar/1994,,0.5,19137.031336957392,operating costs of operator1 + sowing
17/Apr/1994,,0.5,19136.531336957392,operating costs of operator1 + weeding
18/Apr/1994,,0.5,19136.031336957392,operating costs of operator1 + weeding
28/Jun/1994,1061.6402809090912,,20197.671617866483,cropprice (bean)
28/Jun/1994,197.2916729659091,,20394.96329083239,cropprice (maize)
28/Jun/1994,133.33759099999997,,20528.30088183239,cropprice (maize_residue)
28/Jun/1994,,0.5,20527.80088183239,operating costs of operator1 + harvesting
29/Jun/1994,,0.5,20527.30088183239,operating costs of operator1 + harvesting
30/Jun/1994,,606.1,19921.200881832392,Farm Overheads
05/Jul/1994,0.0,,19921.200881832392,cropprice (maize)
05/Jul/1994,30.60236428409091,,19951.803246116484,cropprice (maize_residue)
05/Jul/1994,,0.5,19951.303246116484,operating costs of operator1 + harvesting
07/Aug/1994,,0.5,19950.803246116484,operating costs of operator1 + weeding
14/Aug/1994,,0.5,19950.303246116484,operating costs of operator1 + weeding
01/Sep/1994,,10.0,19940.303246116484,sowing costs
01/Sep/1994,,10.0,19930.303246116484,sowing costs
01/Sep/1994,,0.5,19929.803246116484,operating costs of operator1 + presow_till
02/Sep/1994,,0.5,19929.303246116484,operating costs of operator1 + sowing
03/Sep/1994,,0.5,19928.803246116484,operating costs of operator1 + presow_till
04/Sep/1994,,0.5,19928.303246116484,operating costs of operator1 + sowing
01/Oct/1994,,0.5,19927.803246116484,operating costs of operator1 + weeding
02/Oct/1994,,0.5,19927.303246116484,operating costs of operator1 + weeding
10/Dec/1994,708.1305249289771,,20635.43377104546,cropprice (maize)
10/Dec/1994,64.19840310227274,,20699.632174147733,cropprice (maize_residue)
10/Dec/1994,,0.5,20699.132174147733,operating costs of operator1 + harvesting
31/Dec/1994,0.0,,20699.132174147733,cropprice (maize)
31/Dec/1994,18.386652170454546,,20717.518826318188,cropprice (maize_residue)
31/Dec/1994,,0.5,20717.018826318188,operating costs of operator1 + harvesting
19/Jan/1995,,0.5,20716.518826318188,operating costs of operator1 + weeding
09/Feb/1995,,0.5,20716.018826318188,operating costs of operator1 + weeding
15/Mar/1995,,21.0,20695.018826318188,sowing costs
15/Mar/1995,,21.0,20674.018826318188,sowing costs
15/Mar/1995,,0.5,20673.518826318188,operating costs of operator1 + presow_till
16/Mar/1995,,0.5,20673.018826318188,operating costs of operator1 + sowing
17/Mar/1995,,0.5,20672.518826318188,operating costs of operator1 + presow_till
18/Mar/1995,,0.5,20672.018826318188,operating costs of operator1 + sowing
14/Apr/1995,,0.5,20671.518826318188,operating costs of operator1 + weeding
15/Apr/1995,,0.5,20671.018826318188,operating costs of operator1 + weeding
20/Jun/1995,442.8080083636364,,21113.826834681826,cropprice (bean)
20/Jun/1995,600.335009096591,,21714.161843778416,cropprice (maize)
20/Jun/1995,91.47410999999998,,21805.635953778416,cropprice (maize_residue)
20/Jun/1995,,0.5,21805.135953778416,operating costs of operator1 + harvesting
21/Jun/1995,,0.5,21804.635953778416,operating costs of operator1 + harvesting
30/Jun/1995,,606.1,21198.535953778417,Farm Overheads
07/Jul/1995,0.0,,21198.535953778417,cropprice (maize)
07/Jul/1995,21.673839227272722,,21220.209793005688,cropprice (maize_residue)
07/Jul/1995,,0.5,21219.709793005688,operating costs of operator1 + harvesting
30/Jul/1995,,0.5,21219.209793005688,operating costs of operator1 + weeding
16/Aug/1995,,0.5,21218.709793005688,operating costs of operator1 + weeding
03/Sep/1995,,10.0,21208.709793005688,sowing costs
03/Sep/1995,,10.0,21198.709793005688,sowing costs
03/Sep/1995,,0.5,21198.209793005688,operating costs of operator1 + presow_till
04/Sep/1995,,0.5,21197.709793005688,operating costs of operator1 + sowing
05/Sep/1995,,0.5,21197.209793005688,operating costs of operator1 + presow_till
06/Sep/1995,,0.5,21196.709793005688,operating costs of operator1 + sowing
03/Oct/1995,,0.5,21196.209793005688,operating costs of operator1 + weeding
04/Oct/1995,,0.5,21195.709793005688,operating costs of operator1 + weeding
15/Dec/1995,691.8505952642046,,21887.560388269892,cropprice (maize)
15/Dec/1995,58.028692068181826,,21945.589080338075,cropprice (maize_residue)
15/Dec/1995,,0.5,21945.089080338075,operating costs of operator1 + harvesting
02/Jan/1996,0.0,,21945.089080338075,cropprice (maize)
02/Jan/1996,22.39017001136364,,21967.47925034944,cropprice (maize_residue)
02/Jan/1996,,0.5,21966.97925034944,operating costs of operator1 + harvesting
24/Jan/1996,,0.5,21966.47925034944,operating costs of operator1 + weeding
11/Feb/1996,,0.5,21965.97925034944,operating costs of operator1 + weeding
20/Mar/1996,,21.0,21944.97925034944,sowing costs
20/Mar/1996,,21.0,21923.97925034944,sowing costs
20/Mar/1996,,0.5,21923.47925034944,operating costs of operator1 + presow_till
21/Mar/1996,,0.5,21922.97925034944,operating costs of operator1 + sowing
22/Mar/1996,,0.5,21922.47925034944,operating costs of operator1 + presow_till
23/Mar/1996,,0.5,21921.97925034944,operating costs of operator1 + sowing
19/Apr/1996,,0.5,21921.47925034944,operating costs of operator1 + weeding
20/Apr/1996,,0.5,21920.97925034944,operating costs of operator1 + weeding
29/Jun/1996,921.3275173295455,,22842.306767678983,cropprice (bean)
29/Jun/1996,255.8292202755682,,23098.135987954553,cropprice (maize)
29/Jun/1996,121.60260564772727,,23219.73859360228,cropprice (maize_residue)
29/Jun/1996,,0.5,23219.23859360228,operating costs of operator1 + harvesting
29/Jun/1996,,606.1,22613.13859360228,Farm Overheads
30/Jun/1996,,0.5,22612.63859360228,operating costs of operator1 + harvesting
13/Jul/1996,0.0,,22612.63859360228,cropprice (maize)
13/Jul/1996,25.320140488636365,,22637.958734090917,cropprice (maize_residue)
13/Jul/1996,,0.5,22637.458734090917,operating costs of operator1 + harvesting
08/Aug/1996,,0.5,22636.958734090917,operating costs of operator1 + weeding
22/Aug/1996,,0.5,22636.458734090917,operating costs of operator1 + weeding
30/Aug/1996,,10.0,22626.458734090917,sowing costs
30/Aug/1996,,10.0,22616.458734090917,sowing costs
30/Aug/1996,,0.5,22615.958734090917,operating costs of operator1 + presow_till
31/Aug/1996,,0.5,22615.458734090917,operating costs of operator1 + sowing
01/Sep/1996,,0.5,22614.958734090917,operating costs of operator1 + presow_till
02/Sep/1996,,0.5,22614.458734090917,operating costs of operator1 + sowing
29/Sep/1996,,0.5,22613.958734090917,operating costs of operator1 + weeding
30/Sep/1996,,0.5,22613.458734090917,operating costs of operator1 + weeding
08/Dec/1996,691.6780505965909,,23305.136784687507,cropprice (maize)
08/Dec/1996,55.725319602272734,,23360.86210428978,cropprice (maize_residue)
08/Dec/1996,,0.5,23360.36210428978,operating costs of operator1 + harvesting
29/Dec/1996,0.0,,23360.36210428978,cropprice (maize)
29/Dec/1996,16.36944996590909,,23376.73155425569,cropprice (maize_residue)
29/Dec/1996,,0.5,23376.23155425569,operating costs of operator1 + harvesting
17/Jan/1997,,0.5,23375.73155425569,operating costs of operator1 + weeding
07/Feb/1997,,0.5,23375.23155425569,operating costs of operator1 + weeding
27/Mar/1997,,21.0,23354.23155425569,sowing costs
27/Mar/1997,,21.0,23333.23155425569,sowing costs
27/Mar/1997,,0.5,23332.73155425569,operating costs of operator1 + presow_till
28/Mar/1997,,0.5,23332.23155425569,operating costs of operator1 + sowing
29/Mar/1997,,0.5,23331.73155425569,operating costs of operator1 + presow_till
30/Mar/1997,,0.5,23331.23155425569,operating costs of operator1 + sowing
26/Apr/1997,,0.5,23330.73155425569,operating costs of operator1 + weeding
27/Apr/1997,,0.5,23330.23155425569,operating costs of operator1 + weeding
30/Jun/1997,,606.1,22724.13155425569,Farm Overheads
06/Jul/1997,589.4069408181817,,23313.538495073873,cropprice (bean)
06/Jul/1997,652.3319634801136,,23965.870458553985,cropprice (maize)
06/Jul/1997,97.47901499999999,,24063.349473553986,cropprice (maize_residue)
06/Jul/1997,,0.5,24062.849473553986,operating costs of operator1 + harvesting
07/Jul/1997,,0.5,24062.349473553986,operating costs of operator1 + harvesting
13/Jul/1997,0.0,,24062.349473553986,cropprice (maize)
13/Jul/1997,30.391118829545462,,24092.740592383532,cropprice (maize_residue)
13/Jul/1997,,0.5,24092.240592383532,operating costs of operator1 + harvesting
15/Aug/1997,,0.5,24091.740592383532,operating costs of operator1 + weeding
22/Aug/1997,,0.5,24091.240592383532,operating costs of operator1 + weeding
11/Oct/1997,,10.0,24081.240592383532,sowing costs
11/Oct/1997,,10.0,24071.240592383532,sowing costs
11/Oct/1997,,0.5,24070.740592383532,operating costs of operator1 + presow_till
12/Oct/1997,,0.5,24070.240592383532,operating costs of operator1 + sowing
13/Oct/1997,,0.5,24069.740592383532,operating costs of operator1 + presow_till
14/Oct/1997,,0.5,24069.240592383532,operating costs of operator1 + sowing
10/Nov/1997,,0.5,24068.740592383532,operating costs of operator1 + weeding
11/Nov/1997,,0.5,24068.240592383532,operating costs of operator1 + weeding
19/Jan/1998,662.7568631846591,,24730.99745556819,cropprice (maize)
19/Jan/1998,53.08647017045455,,24784.083925738647,cropprice (maize_residue)
19/Jan/1998,,0.5,24783.583925738647,operating costs of operator1 + harvesting
04/Feb/1998,0.0,,24783.583925738647,cropprice (maize)
04/Feb/1998,21.575048272727276,,24805.158974011374,cropprice (maize_residue)
04/Feb/1998,,0.5,24804.658974011374,operating costs of operator1 + harvesting
28/Feb/1998,,0.5,24804.158974011374,operating costs of operator1 + weeding
16/Mar/1998,,0.5,24803.658974011374,operating costs of operator1 + weeding
26/Mar/1998,,21.0,24782.658974011374,sowing costs
26/Mar/1998,,21.0,24761.658974011374,sowing costs
26/Mar/1998,,0.5,24761.158974011374,operating costs of operator1 + presow_till
27/Mar/1998,,0.5,24760.658974011374,operating costs of operator1 + sowing
28/Mar/1998,,0.5,24760.158974011374,operating costs of operator1 + presow_till
29/Mar/1998,,0.5,24759.658974011374,operating costs of operator1 + sowing
25/Apr/1998,,0.5,24759.158974011374,operating costs of operator1 + weeding
26/Apr/1998,,0.5,24758.658974011374,operating costs of operator1 + weeding
30/Jun/1998,,606.1,24152.558974011376,Farm Overheads
03/Jul/1998,729.5894915113636,,24882.14846552274,cropprice (bean)
03/Jul/1998,18.570369571022727,,24900.71883509376,cropprice (maize)
03/Jul/1998,120.78333629545455,,25021.502171389217,cropprice (maize_residue)
03/Jul/1998,,0.5,25021.002171389217,operating costs of operator1 + harvesting
04/Jul/1998,,0.5,25020.502171389217,operating costs of operator1 + harvesting
19/Jul/1998,0.0,,25020.502171389217,cropprice (maize)
19/Jul/1998,17.720669829545454,,25038.22284121876,cropprice (maize_residue)
19/Jul/1998,,0.5,25037.72284121876,operating costs of operator1 + harvesting
12/Aug/1998,,0.5,25037.22284121876,operating costs of operator1 + weeding
28/Aug/1998,,0.5,25036.72284121876,operating costs of operator1 + weeding
01/Sep/1998,,10.0,25026.72284121876,sowing costs
01/Sep/1998,,10.0,25016.72284121876,sowing costs
01/Sep/1998,,0.5,25016.22284121876,operating costs of operator1 + presow_till
02/Sep/1998,,0.5,25015.72284121876,operating costs of operator1 + sowing
03/Sep/1998,,0.5,25015.22284121876,operating costs of operator1 + presow_till
04/Sep/1998,,0.5,25014.72284121876,operating costs of operator1 + sowing
01/Oct/1998,,0.5,25014.22284121876,operating costs of operator1 + weeding
02/Oct/1998,,0.5,25013.72284121876,operating costs of operator1 + weeding
11/Dec/1998,538.6519550028409,,25552.374796221604,cropprice (maize)
11/Dec/1998,37.078230420454545,,25589.45302664206,cropprice (maize_residue)
11/Dec/1998,,0.5,25588.95302664206,operating costs of operator1 + harvesting
28/Dec/1998,0.0,,25588.95302664206,cropprice (maize)
28/Dec/1998,20.46702159090909,,25609.42004823297,cropprice (maize_residue)
28/Dec/1998,,0.5,25608.92004823297,operating costs of operator1 + harvesting
20/Jan/1999,,0.5,25608.42004823297,operating costs of operator1 + weeding
06/Feb/1999,,0.5,25607.92004823297,operating costs of operator1 + weeding
15/Mar/1999,,21.0,25586.92004823297,sowing costs
15/Mar/1999,,21.0,25565.92004823297,sowing costs
15/Mar/1999,,0.5,25565.42004823297,operating costs of operator1 + presow_till
16/Mar/1999,,0.5,25564.92004823297,operating costs of operator1 + sowing
17/Mar/1999,,0.5,25564.42004823297,operating costs of operator1 + presow_till
18/Mar/1999,,0.5,25563.92004823297,operating costs of operator1 + sowing
14/Apr/1999,,0.5,25563.42004823297,operating costs of operator1 + weeding
15/Apr/1999,,0.5,25562.92004823297,operating costs of operator1 + weeding
24/Jun/1999,665.7107434090908,,26228.63079164206,cropprice (bean)
24/Jun/1999,501.48334026988636,,26730.114131911945,cropprice (maize)
24/Jun/1999,100.56916947727272,,26830.683301389217,cropprice (maize_residue)
24/Jun/1999,,0.5,26830.183301389217,operating costs of operator1 + harvesting
25/Jun/1999,,0.5,26829.683301389217,operating costs of operator1 + harvesting
30/Jun/1999,,606.1,26223.58330138922,Farm Overheads
10/Jul/1999,0.0,,26223.58330138922,cropprice (maize)
10/Jul/1999,24.085266113636365,,26247.668567502857,cropprice (maize_residue)
10/Jul/1999,,0.5,26247.168567502857,operating costs of operator1 + harvesting
03/Aug/1999,,0.5,26246.668567502857,operating costs of operator1 + weeding
19/Aug/1999,,0.5,26246.168567502857,operating costs of operator1 + weeding
01/Sep/1999,,10.0,26236.168567502857,sowing costs
01/Sep/1999,,10.0,26226.168567502857,sowing costs
01/Sep/1999,,0.5,26225.668567502857,operating costs of operator1 + presow_till
02/Sep/1999,,0.5,26225.168567502857,operating costs of operator1 + sowing
03/Sep/1999,,0.5,26224.668567502857,operating costs of operator1 + presow_till
04/Sep/1999,,0.5,26224.168567502857,operating costs of operator1 + sowing
01/Oct/1999,,0.5,26223.668567502857,operating costs of operator1 + weeding
02/Oct/1999,,0.5,26223.168567502857,operating costs of operator1 + weeding
12/Dec/1999,673.1926291619318,,26896.361196664788,cropprice (maize)
12/Dec/1999,52.09267911363636,,26948.453875778425,cropprice (maize_residue)
12/Dec/1999,,0.5,26947.953875778425,operating costs of operator1 + harvesting
02/Jan/2000,0.0,,26947.953875778425,cropprice (maize)
02/Jan/2000,15.730183000000002,,26963.684058778425,cropprice (maize_residue)
02/Jan/2000,,0.5,26963.184058778425,operating costs of operator1 + harvesting
21/Jan/2000,,0.5,26962.684058778425,operating costs of operator1 + weeding
11/Feb/2000,,0.5,26962.184058778425,operating costs of operator1 + weeding
19/Mar/2000,,21.0,26941.184058778425,sowing costs
19/Mar/2000,,21.0,26920.184058778425,sowing costs
19/Mar/2000,,0.5,26919.684058778425,operating costs of operator1 + presow_till
20/Mar/2000,,0.5,26919.184058778425,operating costs of operator1 + sowing
21/Mar/2000,,0.5,26918.684058778425,operating costs of operator1 + presow_till
22/Mar/2000,,0.5,26918.184058778425,operating costs of operator1 + sowing
18/Apr/2000,,0.5,26917.684058778425,operating costs of operator1 + weeding
19/Apr/2000,,0.5,26917.184058778425,operating costs of operator1 + weeding
23/Jun/2000,170.51075045454547,,27087.69480923297,cropprice (bean)
23/Jun/2000,629.9518421590909,,27717.64665139206,cropprice (maize)
23/Jun/2000,65.35453657954545,,27783.001187971608,cropprice (maize_residue)
23/Jun/2000,,0.5,27782.501187971608,operating costs of operator1 + harvesting
24/Jun/2000,,0.5,27782.001187971608,operating costs of operator1 + harvesting
29/Jun/2000,,606.1,27175.90118797161,Farm Overheads
01/Jul/2000,0.0,,27175.90118797161,cropprice (maize)
01/Jul/2000,32.958099363636364,,27208.859287335246,cropprice (maize_residue)
01/Jul/2000,,0.5,27208.359287335246,operating costs of operator1 + harvesting
02/Aug/2000,,0.5,27207.859287335246,operating costs of operator1 + weeding
10/Aug/2000,,0.5,27207.359287335246,operating costs of operator1 + weeding
30/Aug/2000,,10.0,27197.359287335246,sowing costs
30/Aug/2000,,10.0,27187.359287335246,sowing costs
30/Aug/2000,,0.5,27186.859287335246,operating costs of operator1 + presow_till
31/Aug/2000,,0.5,27186.359287335246,operating costs of operator1 + sowing
01/Sep/2000,,0.5,27185.859287335246,operating costs of operator1 + presow_till
02/Sep/2000,,0.5,27185.359287335246,operating costs of operator1 + sowing
29/Sep/2000,,0.5,27184.859287335246,operating costs of operator1 + weeding
30/Sep/2000,,0.5,27184.359287335246,operating costs of operator1 + weeding
08/Dec/2000,464.84561705965905,,27649.204904394905,cropprice (maize)
08/Dec/2000,32.91243675,,27682.117341144905,cropprice (maize_residue)
08/Dec/2000,,0.5,27681.617341144905,operating costs of operator1 + harvesting
30/Dec/2000,0.0,,27681.617341144905,cropprice (maize)
30/Dec/2000,13.606170659090909,,27695.223511803997,cropprice (maize_residue)
30/Dec/2000,,0.5,27694.723511803997,operating costs of operator1 + harvesting
17/Jan/2001,,0.5,27694.223511803997,operating costs of operator1 + weeding
08/Feb/2001,,0.5,27693.723511803997,operating costs of operator1 + weeding
15/Mar/2001,,21.0,27672.723511803997,sowing costs
15/Mar/2001,,21.0,27651.723511803997,sowing costs
15/Mar/2001,,0.5,27651.223511803997,operating costs of operator1 + presow_till
16/Mar/2001,,0.5,27650.723511803997,operating costs of operator1 + sowing
17/Mar/2001,,0.5,27650.223511803997,operating costs of operator1 + presow_till
18/Mar/2001,,0.5,27649.723511803997,operating costs of operator1 + sowing
14/Apr/2001,,0.5,27649.223511803997,operating costs of operator1 + weeding
15/Apr/2001,,0.5,27648.723511803997,operating costs of operator1 + weeding
23/Jun/2001,921.3504140113637,,28570.073925815363,cropprice (bean)
23/Jun/2001,220.53824756249998,,28790.612173377864,cropprice (maize)
23/Jun/2001,126.69828657954547,,28917.31045995741,cropprice (maize_residue)
23/Jun/2001,,0.5,28916.81045995741,operating costs of operator1 + harvesting
24/Jun/2001,,0.5,28916.31045995741,operating costs of operator1 + harvesting
30/Jun/2001,,606.1,28310.210459957412,Farm Overheads
06/Jul/2001,0.0,,28310.210459957412,cropprice (maize)
06/Jul/2001,22.934946238636368,,28333.14540619605,cropprice (maize_residue)
06/Jul/2001,,0.5,28332.64540619605,operating costs of operator1 + harvesting
02/Aug/2001,,0.5,28332.14540619605,operating costs of operator1 + weeding
15/Aug/2001,,0.5,28331.64540619605,operating costs of operator1 + weeding
01/Sep/2001,,10.0,28321.64540619605,sowing costs
01/Sep/2001,,10.0,28311.64540619605,sowing costs
01/Sep/2001,,0.5,28311.14540619605,operating costs of operator1 + presow_till
02/Sep/2001,,0.5,28310.64540619605,operating costs of operator1 + sowing
03/Sep/2001,,0.5,28310.14540619605,operating costs of operator1 + presow_till
04/Sep/2001,,0.5,28309.64540619605,operating costs of operator1 + sowing
01/Oct/2001,,0.5,28309.14540619605,operating costs of operator1 + weeding
02/Oct/2001,,0.5,28308.64540619605,operating costs of operator1 + weeding
08/Dec/2001,693.4554488863637,,29002.100855082415,cropprice (maize)
08/Dec/2001,51.7738259090909,,29053.874680991506,cropprice (maize_residue)
08/Dec/2001,,0.5,29053.374680991506,operating costs of operator1 + harvesting
28/Dec/2001,0.0,,29053.374680991506,cropprice (maize)
28/Dec/2001,15.024106113636362,,29068.398787105143,cropprice (maize_residue)
28/Dec/2001,,0.5,29067.898787105143,operating costs of operator1 + harvesting
17/Jan/2002,,0.5,29067.398787105143,operating costs of operator1 + weeding
06/Feb/2002,,0.5,29066.898787105143,operating costs of operator1 + weeding
15/Mar/2002,,21.0,29045.898787105143,sowing costs
15/Mar/2002,,21.0,29024.898787105143,sowing costs
15/Mar/2002,,0.5,29024.398787105143,operating costs of operator1 + presow_till
16/Mar/2002,,0.5,29023.898787105143,operating costs of operator1 + sowing
17/Mar/2002,,0.5,29023.398787105143,operating costs of operator1 + presow_till
18/Mar/2002,,0.5,29022.898787105143,operating costs of operator1 + sowing
14/Apr/2002,,0.5,29022.398787105143,operating costs of operator1 + weeding
15/Apr/2002,,0.5,29021.898787105143,operating costs of operator1 + weeding
19/Jun/2002,529.2307850454545,,29551.129572150596,cropprice (bean)
19/Jun/2002,466.34655644318184,,30017.47612859378,cropprice (maize)
19/Jun/2002,94.29199219318181,,30111.76812078696,cropprice (maize_residue)
19/Jun/2002,,0.5,30111.26812078696,operating costs of operator1 + harvesting
20/Jun/2002,,0.5,30110.76812078696,operating costs of operator1 + harvesting
29/Jun/2002,0.0,,30110.76812078696,cropprice (maize)
29/Jun/2002,25.745930068181817,,30136.51405085514,cropprice (maize_residue)
29/Jun/2002,,0.5,30136.01405085514,operating costs of operator1 + harvesting
30/Jun/2002,,606.1,29529.914050855143,Farm Overheads
29/Jul/2002,,0.5,29529.414050855143,operating costs of operator1 + weeding
08/Aug/2002,,0.5,29528.914050855143,operating costs of operator1 + weeding
03/Sep/2002,,10.0,29518.914050855143,sowing costs
03/Sep/2002,,10.0,29508.914050855143,sowing costs
03/Sep/2002,,0.5,29508.414050855143,operating costs of operator1 + presow_till
04/Sep/2002,,0.5,29507.914050855143,operating costs of operator1 + sowing
05/Sep/2002,,0.5,29507.414050855143,operating costs of operator1 + presow_till
06/Sep/2002,,0.5,29506.914050855143,operating costs of operator1 + sowing
03/Oct/2002,,0.5,29506.414050855143,operating costs of operator1 + weeding
04/Oct/2002,,0.5,29505.914050855143,operating costs of operator1 + weeding
08/Dec/2002,688.3938571448864,,30194.307908000028,cropprice (maize)
08/Dec/2002,50.66543856818182,,30244.97334656821,cropprice (maize_residue)
08/Dec/2002,,0.5,30244.47334656821,operating costs of operator1 + harvesting
28/Dec/2002,0.0,,30244.47334656821,cropprice (maize)
28/Dec/2002,16.561393045454544,,30261.034739613664,cropprice (maize_residue)
28/Dec/2002,,0.5,30260.534739613664,operating costs of operator1 + harvesting
17/Jan/2003,,0.5,30260.034739613664,operating costs of operator1 + weeding
06/Feb/2003,,0.5,30259.534739613664,operating costs of operator1 + weeding
27/Mar/2003,,21.0,30238.534739613664,sowing costs
27/Mar/2003,,21.0,30217.534739613664,sowing costs
27/Mar/2003,,0.5,30217.034739613664,operating costs of operator1 + presow_till
28/Mar/2003,,0.5,30216.534739613664,operating costs of operator1 + sowing
29/Mar/2003,,0.5,30216.034739613664,operating costs of operator1 + presow_till
30/Mar/2003,,0.5,30215.534739613664,operating costs of operator1 + sowing
26/Apr/2003,,0.5,30215.034739613664,operating costs of operator1 + weeding
27/Apr/2003,,0.5,30214.534739613664,operating costs of operator1 + weeding
30/Jun/2003,,606.1,29608.434739613665,Farm Overheads
02/Jul/2003,181.52083854545458,,29789.95557815912,cropprice (bean)
02/Jul/2003,612.1792896051137,,30402.13486776423,cropprice (maize)
02/Jul/2003,56.80626331818182,,30458.941131082414,cropprice (maize_residue)
02/Jul/2003,,0.5,30458.441131082414,operating costs of operator1 + harvesting
03/Jul/2003,,0.5,30457.941131082414,operating costs of operator1 + harvesting
10/Jul/2003,0.0,,30457.941131082414,cropprice (maize)
10/Jul/2003,27.259604715909088,,30485.200735798324,cropprice (maize_residue)
10/Jul/2003,,0.5,30484.700735798324,operating costs of operator1 + harvesting
11/Aug/2003,,0.5,30484.200735798324,operating costs of operator1 + weeding
19/Aug/2003,,0.5,30483.700735798324,operating costs of operator1 + weeding
03/Sep/2003,,10.0,30473.700735798324,sowing costs
03/Sep/2003,,10.0,30463.700735798324,sowing costs
03/Sep/2003,,0.5,30463.200735798324,operating costs of operator1 + presow_till
04/Sep/2003,,0.5,30462.700735798324,operating costs of operator1 + sowing
05/Sep/2003,,0.5,30462.200735798324,operating costs of operator1 + presow_till
06/Sep/2003,,0.5,30461.700735798324,operating costs of operator1 + sowing
03/Oct/2003,,0.5,30461.200735798324,operating costs of operator1 + weeding
04/Oct/2003,,0.5,30460.700735798324,operating costs of operator1 + weeding
11/Dec/2003,10.998310798295453,,30471.69904659662,cropprice (maize)
11/Dec/2003,35.99825772727273,,30507.69730432389,cropprice (maize_residue)
11/Dec/2003,,0.5,30507.19730432389,operating costs of operator1 + harvesting
01/Jan/2004,0.0,,30507.19730432389,cropprice (maize)
01/Jan/2004,10.646133420454545,,30517.843437744345,cropprice (maize_residue)
01/Jan/2004,,0.5,30517.343437744345,operating costs of operator1 + harvesting
20/Jan/2004,,0.5,30516.843437744345,operating costs of operator1 + weeding
10/Feb/2004,,0.5,30516.343437744345,operating costs of operator1 + weeding
14/Mar/2004,,21.0,30495.343437744345,sowing costs
14/Mar/2004,,21.0,30474.343437744345,sowing costs
14/Mar/2004,,0.5,30473.843437744345,operating costs of operator1 + presow_till
15/Mar/2004,,0.5,30473.343437744345,operating costs of operator1 + sowing
16/Mar/2004,,0.5,30472.843437744345,operating costs of operator1 + presow_till
17/Mar/2004,,0.5,30472.343437744345,operating costs of operator1 + sowing
13/Apr/2004,,0.5,30471.843437744345,operating costs of operator1 + weeding
14/Apr/2004,,0.5,30471.343437744345,operating costs of operator1 + weeding
23/Jun/2004,0.0,,30471.343437744345,cropprice (maize)
23/Jun/2004,27.73273814772727,,30499.07617589207,cropprice (maize_residue)
23/Jun/2004,,0.5,30498.57617589207,operating costs of operator1 + harvesting
25/Jun/2004,807.1580200568181,,31305.734195948888,cropprice (bean)
25/Jun/2004,0.0,,31305.734195948888,cropprice (maize)
25/Jun/2004,101.13967063636363,,31406.87386658525,cropprice (maize_residue)
25/Jun/2004,,0.5,31406.37386658525,operating costs of operator1 + harvesting
26/Jun/2004,,0.5,31405.87386658525,operating costs of operator1 + harvesting
29/Jun/2004,,606.1,30799.773866585252,Farm Overheads
02/Aug/2004,,0.5,30799.273866585252,operating costs of operator1 + weeding
04/Aug/2004,,0.5,30798.773866585252,operating costs of operator1 + weeding
04/Sep/2004,,10.0,30788.773866585252,sowing costs
04/Sep/2004,,10.0,30778.773866585252,sowing costs
04/Sep/2004,,0.5,30778.273866585252,operating costs of operator1 + presow_till
05/Sep/2004,,0.5,30777.773866585252,operating costs of operator1 + sowing
06/Sep/2004,,0.5,30777.273866585252,operating costs of operator1 + presow_till
07/Sep/2004,,0.5,30776.773866585252,operating costs of operator1 + sowing
04/Oct/2004,,0.5,30776.273866585252,operating costs of operator1 + weeding
05/Oct/2004,,0.5,30775.773866585252,operating costs of operator1 + weeding
10/Dec/2004,475.5129325823864,,31251.28679916764,cropprice (maize)
10/Dec/2004,31.42792857954545,,31282.714727747185,cropprice (maize_residue)
10/Dec/2004,,0.5,31282.214727747185,operating costs of operator1 + harvesting
30/Dec/2004,0.0,,31282.214727747185,cropprice (maize)
30/Dec/2004,13.807364727272729,,31296.022092474457,cropprice (maize_residue)
30/Dec/2004,,0.5,31295.522092474457,operating costs of operator1 + harvesting
19/Jan/2005,,0.5,31295.022092474457,operating costs of operator1 + weeding
08/Feb/2005,,0.5,31294.522092474457,operating costs of operator1 + weeding
22/Mar/2005,,21.0,31273.522092474457,sowing costs
22/Mar/2005,,21.0,31252.522092474457,sowing costs
22/Mar/2005,,0.5,31252.022092474457,operating costs of operator1 + presow_till
23/Mar/2005,,0.5,31251.522092474457,operating costs of operator1 + sowing
24/Mar/2005,,0.5,31251.022092474457,operating costs of operator1 + presow_till
25/Mar/2005,,0.5,31250.522092474457,operating costs of operator1 + sowing
21/Apr/2005,,0.5,31250.022092474457,operating costs of operator1 + weeding
22/Apr/2005,,0.5,31249.522092474457,operating costs of operator1 + weeding
25/Jun/2005,182.47199035227277,,31431.994082826728,cropprice (bean)
25/Jun/2005,633.7881737215909,,32065.78225654832,cropprice (maize)
25/Jun/2005,60.57835804545454,,32126.360614593774,cropprice (maize_residue)
25/Jun/2005,,0.5,32125.860614593774,operating costs of operator1 + harvesting
26/Jun/2005,,0.5,32125.360614593774,operating costs of operator1 + harvesting
30/Jun/2005,,606.1,31519.260614593775,Farm Overheads
03/Jul/2005,0.0,,31519.260614593775,cropprice (maize)
03/Jul/2005,26.79928865909091,,31546.059903252866,cropprice (maize_residue)
03/Jul/2005,,0.5,31545.559903252866,operating costs of operator1 + harvesting
04/Aug/2005,,0.5,31545.059903252866,operating costs of operator1 + weeding
12/Aug/2005,,0.5,31544.559903252866,operating costs of operator1 + weeding
01/Sep/2005,,10.0,31534.559903252866,sowing costs
01/Sep/2005,,10.0,31524.559903252866,sowing costs
01/Sep/2005,,0.5,31524.059903252866,operating costs of operator1 + presow_till
02/Sep/2005,,0.5,31523.559903252866,operating costs of operator1 + sowing
03/Sep/2005,,0.5,31523.059903252866,operating costs of operator1 + presow_till
04/Sep/2005,,0.5,31522.559903252866,operating costs of operator1 + sowing
01/Oct/2005,,0.5,31522.059903252866,operating costs of operator1 + weeding
02/Oct/2005,,0.5,31521.559903252866,operating costs of operator1 + weeding
09/Dec/2005,0.0,,31521.559903252866,cropprice (maize)
09/Dec/2005,36.356872556818175,,31557.916775809685,cropprice (maize_residue)
09/Dec/2005,,0.5,31557.416775809685,operating costs of operator1 + harvesting
27/Dec/2005,0.0,,31557.416775809685,cropprice (maize)
27/Dec/2005,9.116098579545454,,31566.53287438923,cropprice (maize_residue)
27/Dec/2005,,0.5,31566.03287438923,operating costs of operator1 + harvesting
18/Jan/2006,,0.5,31565.53287438923,operating costs of operator1 + weeding
05/Feb/2006,,0.5,31565.03287438923,operating costs of operator1 + weeding
19/Mar/2006,,21.0,31544.03287438923,sowing costs
19/Mar/2006,,21.0,31523.03287438923,sowing costs
19/Mar/2006,,0.5,31522.53287438923,operating costs of operator1 + presow_till
20/Mar/2006,,0.5,31522.03287438923,operating costs of operator1 + sowing
21/Mar/2006,,0.5,31521.53287438923,operating costs of operator1 + presow_till
22/Mar/2006,,0.5,31521.03287438923,operating costs of operator1 + sowing
18/Apr/2006,,0.5,31520.53287438923,operating costs of operator1 + weeding
19/Apr/2006,,0.5,31520.03287438923,operating costs of operator1 + weeding
30/Jun/2006,,606.1,30913.932874389233,Farm Overheads
11/Jul/2006,1426.927301625,,32340.860176014234,cropprice (bean)
11/Jul/2006,0.0,,32340.860176014234,cropprice (maize)
11/Jul/2006,92.54840643181817,,32433.408582446053,cropprice (maize_residue)
11/Jul/2006,0.0,,32433.408582446053,cropprice (maize)
11/Jul/2006,21.235434795454545,,32454.644017241506,cropprice (maize_residue)
11/Jul/2006,,0.5,32454.144017241506,operating costs of operator1 + harvesting
12/Jul/2006,,0.5,32453.644017241506,operating costs of operator1 + harvesting
13/Jul/2006,,0.5,32453.144017241506,operating costs of operator1 + harvesting
20/Aug/2006,,0.5,32452.644017241506,operating costs of operator1 + weeding
21/Aug/2006,,0.5,32452.144017241506,operating costs of operator1 + weeding
01/Sep/2006,,10.0,32442.144017241506,sowing costs
01/Sep/2006,,10.0,32432.144017241506,sowing costs
01/Sep/2006,,0.5,32431.644017241506,operating costs of operator1 + presow_till
02/Sep/2006,,0.5,32431.144017241506,operating costs of operator1 + sowing
03/Sep/2006,,0.5,32430.644017241506,operating costs of operator1 + presow_till
04/Sep/2006,,0.5,32430.144017241506,operating costs of operator1 + sowing
01/Oct/2006,,0.5,32429.644017241506,operating costs of operator1 + weeding
02/Oct/2006,,0.5,32429.144017241506,operating costs of operator1 + weeding
08/Dec/2006,640.6183021960228,,33069.76231943753,cropprice (maize)
08/Dec/2006,39.23404207954546,,33108.99636151707,cropprice (maize_residue)
08/Dec/2006,,0.5,33108.49636151707,operating costs of operator1 + harvesting
31/Dec/2006,0.0,,33108.49636151707,cropprice (maize)
31/Dec/2006,14.682764227272727,,33123.17912574434,cropprice (maize_residue)
31/Dec/2006,,0.5,33122.67912574434,operating costs of operator1 + harvesting
17/Jan/2007,,0.5,33122.17912574434,operating costs of operator1 + weeding
09/Feb/2007,,0.5,33121.67912574434,operating costs of operator1 + weeding
18/Mar/2007,,21.0,33100.67912574434,sowing costs
18/Mar/2007,,21.0,33079.67912574434,sowing costs
18/Mar/2007,,0.5,33079.17912574434,operating costs of operator1 + presow_till
19/Mar/2007,,0.5,33078.67912574434,operating costs of operator1 + sowing
20/Mar/2007,,0.5,33078.17912574434,operating costs of operator1 + presow_till
21/Mar/2007,,0.5,33077.67912574434,operating costs of operator1 + sowing
17/Apr/2007,,0.5,33077.17912574434,operating costs of operator1 + weeding
18/Apr/2007,,0.5,33076.67912574434,operating costs of operator1 + weeding
21/Jun/2007,176.89907979545455,,33253.578205539794,cropprice (bean)
21/Jun/2007,653.4233065312501,,33907.001512071045,cropprice (maize)
21/Jun/2007,66.95008988636363,,33973.95160195741,cropprice (maize_residue)
21/Jun/2007,,0.5,33973.45160195741,operating costs of operator1 + harvesting
22/Jun/2007,,0.5,33972.95160195741,operating costs of operator1 + harvesting
30/Jun/2007,,606.1,33366.85160195741,Farm Overheads
08/Jul/2007,0.0,,33366.85160195741,cropprice (maize)
08/Jul/2007,21.74903730681818,,33388.60063926423,cropprice (maize_residue)
08/Jul/2007,,0.5,33388.10063926423,operating costs of operator1 + harvesting
31/Jul/2007,,0.5,33387.60063926423,operating costs of operator1 + weeding
17/Aug/2007,,0.5,33387.10063926423,operating costs of operator1 + weeding
01/Sep/2007,,10.0,33377.10063926423,sowing costs
01/Sep/2007,,10.0,33367.10063926423,sowing costs
01/Sep/2007,,0.5,33366.60063926423,operating costs of operator1 + presow_till
02/Sep/2007,,0.5,33366.10063926423,operating costs of operator1 + sowing
03/Sep/2007,,0.5,33365.60063926423,operating costs of operator1 + presow_till
04/Sep/2007,,0.5,33365.10063926423,operating costs of operator1 + sowing
01/Oct/2007,,0.5,33364.60063926423,operating costs of operator1 + weeding
02/Oct/2007,,0.5,33364.10063926423,operating costs of operator1 + weeding
10/Dec/2007,260.48888331818176,,33624.58952258241,cropprice (maize)
10/Dec/2007,35.16638461363637,,33659.75590719605,cropprice (maize_residue)
10/Dec/2007,,0.5,33659.25590719605,operating costs of operator1 + harvesting
03/Jan/2008,0.0,,33659.25590719605,cropprice (maize)
03/Jan/2008,12.598208340909087,,33671.85411553696,cropprice (maize_residue)
03/Jan/2008,,0.5,33671.35411553696,operating costs of operator1 + harvesting
19/Jan/2008,,0.5,33670.85411553696,operating costs of operator1 + weeding
12/Feb/2008,,0.5,33670.35411553696,operating costs of operator1 + weeding
17/Mar/2008,,21.0,33649.35411553696,sowing costs
17/Mar/2008,,21.0,33628.35411553696,sowing costs
17/Mar/2008,,0.5,33627.85411553696,operating costs of operator1 + presow_till
18/Mar/2008,,0.5,33627.35411553696,operating costs of operator1 + sowing
19/Mar/2008,,0.5,33626.85411553696,operating costs of operator1 + presow_till
20/Mar/2008,,0.5,33626.35411553696,operating costs of operator1 + sowing
16/Apr/2008,,0.5,33625.85411553696,operating costs of operator1 + weeding
17/Apr/2008,,0.5,33625.35411553696,operating costs of operator1 + weeding
24/Jun/2008,762.3587035909093,,34387.71281912787,cropprice (bean)
24/Jun/2008,406.9384160710227,,34794.65123519889,cropprice (maize)
24/Jun/2008,114.10445889772728,,34908.75569409662,cropprice (maize_residue)
24/Jun/2008,,0.5,34908.25569409662,operating costs of operator1 + harvesting
25/Jun/2008,,0.5,34907.75569409662,operating costs of operator1 + harvesting
29/Jun/2008,,606.1,34301.65569409662,Farm Overheads
05/Jul/2008,0.0,,34301.65569409662,cropprice (maize)
05/Jul/2008,25.669566761363637,,34327.32526085798,cropprice (maize_residue)
05/Jul/2008,,0.5,34326.82526085798,operating costs of operator1 + harvesting
03/Aug/2008,,0.5,34326.32526085798,operating costs of operator1 + weeding
14/Aug/2008,,0.5,34325.82526085798,operating costs of operator1 + weeding
30/Aug/2008,,10.0,34315.82526085798,sowing costs
30/Aug/2008,,10.0,34305.82526085798,sowing costs
30/Aug/2008,,0.5,34305.32526085798,operating costs of operator1 + presow_till
31/Aug/2008,,0.5,34304.82526085798,operating costs of operator1 + sowing
01/Sep/2008,,0.5,34304.32526085798,operating costs of operator1 + presow_till
02/Sep/2008,,0.5,34303.82526085798,operating costs of operator1 + sowing
29/Sep/2008,,0.5,34303.32526085798,operating costs of operator1 + weeding
30/Sep/2008,,0.5,34302.82526085798,operating costs of operator1 + weeding
06/Dec/2008,654.5676961789773,,34957.39295703696,cropprice (maize)
06/Dec/2008,44.01868230681818,,35001.41163934378,cropprice (maize_residue)
06/Dec/2008,,0.5,35000.91163934378,operating costs of operator1 + harvesting
29/Dec/2008,0.0,,35000.91163934378,cropprice (maize)
29/Dec/2008,11.748444988636365,,35012.66008433242,cropprice (maize_residue)
29/Dec/2008,,0.5,35012.16008433242,operating costs of operator1 + harvesting
15/Jan/2009,,0.5,35011.66008433242,operating costs of operator1 + weeding
07/Feb/2009,,0.5,35011.16008433242,operating costs of operator1 + weeding
18/Mar/2009,,21.0,34990.16008433242,sowing costs
18/Mar/2009,,21.0,34969.16008433242,sowing costs
18/Mar/2009,,0.5,34968.66008433242,operating costs of operator1 + presow_till
19/Mar/2009,,0.5,34968.16008433242,operating costs of operator1 + sowing
20/Mar/2009,,0.5,34967.66008433242,operating costs of operator1 + presow_till
21/Mar/2009,,0.5,34967.16008433242,operating costs of operator1 + sowing
17/Apr/2009,,0.5,34966.66008433242,operating costs of operator1 + weeding
18/Apr/2009,,0.5,34966.16008433242,operating costs of operator1 + weeding
20/Jun/2009,138.61741711363632,,35104.77750144606,cropprice (bean)
20/Jun/2009,677.7887530738637,,35782.56625451992,cropprice (maize)
20/Jun/2009,64.33483331818182,,35846.9010878381,cropprice (maize_residue)
20/Jun/2009,,0.5,35846.4010878381,operating costs of operator1 + harvesting
21/Jun/2009,,0.5,35845.9010878381,operating costs of operator1 + harvesting
30/Jun/2009,0.0,,35845.9010878381,cropprice (maize)
30/Jun/2009,25.928749772727272,,35871.82983761083,cropprice (maize_residue)
30/Jun/2009,,0.5,35871.32983761083,operating costs of operator1 + harvesting
30/Jun/2009,,606.1,35265.22983761083,Farm Overheads
30/Jul/2009,,0.5,35264.72983761083,operating costs of operator1 + weeding
09/Aug/2009,,0.5,35264.22983761083,operating costs of operator1 + weeding
01/Sep/2009,,10.0,35254.22983761083,sowing costs
01/Sep/2009,,10.0,35244.22983761083,sowing costs
01/Sep/2009,,0.5,35243.72983761083,operating costs of operator1 + presow_till
02/Sep/2009,,0.5,35243.22983761083,operating costs of operator1 + sowing
03/Sep/2009,,0.5,35242.72983761083,operating costs of operator1 + presow_till
04/Sep/2009,,0.5,35242.22983761083,operating costs of operator1 + sowing
01/Oct/2009,,0.5,35241.72983761083,operating costs of operator1 + weeding
02/Oct/2009,,0.5,35241.22983761083,operating costs of operator1 + weeding
09/Dec/2009,186.24577704545453,,35427.47561465629,cropprice (maize)
09/Dec/2009,36.18385453409091,,35463.65946919038,cropprice (maize_residue)
09/Dec/2009,,0.5,35463.15946919038,operating costs of operator1 + harvesting
29/Dec/2009,0.0,,35463.15946919038,cropprice (maize)
29/Dec/2009,11.842774829545455,,35475.002244019925,cropprice (maize_residue)
29/Dec/2009,,0.5,35474.502244019925,operating costs of operator1 + harvesting
18/Jan/2010,,0.5,35474.002244019925,operating costs of operator1 + weeding
07/Feb/2010,,0.5,35473.502244019925,operating costs of operator1 + weeding
18/Mar/2010,,21.0,35452.502244019925,sowing costs
18/Mar/2010,,21.0,35431.502244019925,sowing costs
18/Mar/2010,,0.5,35431.002244019925,operating costs of operator1 + presow_till
19/Mar/2010,,0.5,35430.502244019925,operating costs of operator1 + sowing
20/Mar/2010,,0.5,35430.002244019925,operating costs of operator1 + presow_till
21/Mar/2010,,0.5,35429.502244019925,operating costs of operator1 + sowing
17/Apr/2010,,0.5,35429.002244019925,operating costs of operator1 + weeding
18/Apr/2010,,0.5,35428.502244019925,operating costs of operator1 + weeding
20/Jun/2010,188.01386267045453,,35616.51610669038,cropprice (bean)
20/Jun/2010,465.7075394829546,,36082.223646173334,cropprice (maize)
20/Jun/2010,58.34863281818181,,36140.572278991516,cropprice (maize_residue)
20/Jun/2010,,0.5,36140.072278991516,operating costs of operator1 + harvesting
21/Jun/2010,,0.5,36139.572278991516,operating costs of operator1 + harvesting
30/Jun/2010,,606.1,35533.47227899152,Farm Overheads
01/Jul/2010,0.0,,35533.47227899152,cropprice (maize)
01/Jul/2010,24.66397927272727,,35558.13625826425,cropprice (maize_residue)
01/Jul/2010,,0.5,35557.63625826425,operating costs of operator1 + harvesting
30/Jul/2010,,0.5,35557.13625826425,operating costs of operator1 + weeding
10/Aug/2010,,0.5,35556.63625826425,operating costs of operator1 + weeding
01/Sep/2010,,10.0,35546.63625826425,sowing costs
01/Sep/2010,,10.0,35536.63625826425,sowing costs
01/Sep/2010,,0.5,35536.13625826425,operating costs of operator1 + presow_till
02/Sep/2010,,0.5,35535.63625826425,operating costs of operator1 + sowing
03/Sep/2010,,0.5,35535.13625826425,operating costs of operator1 + presow_till
04/Sep/2010,,0.5,35534.63625826425,operating costs of operator1 + sowing
01/Oct/2010,,0.5,35534.13625826425,operating costs of operator1 + weeding
02/Oct/2010,,0.5,35533.63625826425,operating costs of operator1 + weeding
09/Dec/2010,139.59975887215907,,35673.236017136405,cropprice (maize)
09/Dec/2010,38.54230290909091,,35711.778320045494,cropprice (maize_residue)
09/Dec/2010,,0.5,35711.278320045494,operating costs of operator1 + harvesting
27/Dec/2010,0.0,,35711.278320045494,cropprice (maize)
27/Dec/2010,12.852977409090911,,35724.13129745459,cropprice (maize_residue)
27/Dec/2010,,0.5,35723.63129745459,operating costs of operator1 + harvesting
