date,income,expenditure,balance,comment
08/Sep/1979,,15.0,-15.0,sowing costs
08/Sep/1979,,5.0,-20.0,sowing costs
08/Sep/1979,,0.75,-20.75,operating costs of operator1 + presow_till
09/Sep/1979,,0.75,-21.5,operating costs of operator1 + sowing
10/Sep/1979,,0.25,-21.75,operating costs of operator1 + presow_till
11/Sep/1979,,0.25,-22.0,operating costs of operator1 + sowing
08/Oct/1979,,0.75,-22.75,operating costs of operator1 + weeding
09/Oct/1979,,0.25,-23.0,operating costs of operator1 + weeding
21/Dec/1979,0.0,,-23.0,cropprice (maize)
21/Dec/1979,45.936555340909095,,22.936555340909095,cropprice (maize_residue)
21/Dec/1979,0.0,,22.936555340909095,cropprice (maize)
21/Dec/1979,15.312185113636366,,38.24874045454546,cropprice (maize_residue)
21/Dec/1979,,0.75,37.49874045454546,operating costs of operator1 + harvesting
22/Dec/1979,,0.25,37.24874045454546,operating costs of operator1 + harvesting
30/Jan/1980,,0.75,36.49874045454546,operating costs of operator1 + weeding
31/Jan/1980,,0.25,36.24874045454546,operating costs of operator1 + weeding
08/Apr/1980,,31.5,4.748740454545462,sowing costs
08/Apr/1980,,10.5,-5.751259545454538,sowing costs
08/Apr/1980,,0.75,-6.501259545454538,operating costs of operator1 + presow_till
09/Apr/1980,,0.75,-7.251259545454538,operating costs of operator1 + sowing
10/Apr/1980,,0.25,-7.501259545454538,operating costs of operator1 + presow_till
11/Apr/1980,,0.25,-7.751259545454538,operating costs of operator1 + sowing
08/May/1980,,0.75,-8.501259545454538,operating costs of operator1 + weeding
09/May/1980,,0.25,-8.751259545454538,operating costs of operator1 + weeding
29/Jun/1980,,606.1,-614.8512595454546,Farm Overheads
18/Jul/1980,240.03321073295456,,-374.8180488125,cropprice (maize)
18/Jul/1980,15.26791659090909,,-359.55013222159096,cropprice (maize_residue)
18/Jul/1980,,0.25,-359.80013222159096,operating costs of operator1 + harvesting
29/Jul/1980,2388.2666098295454,,2028.4664776079544,cropprice (bean)
29/Jul/1980,0.0,,2028.4664776079544,cropprice (maize)
29/Jul/1980,174.9447409943182,,2203.4112186022726,cropprice (maize_residue)
29/Jul/1980,,0.75,2202.6612186022726,operating costs of operator1 + harvesting
30/Jul/1980,,0.75,2201.9112186022726,operating costs of operator1 + harvesting
27/Aug/1980,,0.25,2201.6612186022726,operating costs of operator1 + weeding
31/Aug/1980,,15.0,2186.6612186022726,sowing costs
31/Aug/1980,,5.0,2181.6612186022726,sowing costs
31/Aug/1980,,0.75,2180.9112186022726,operating costs of operator1 + presow_till
01/Sep/1980,,0.75,2180.1612186022726,operating costs of operator1 + sowing
02/Sep/1980,,0.25,2179.9112186022726,operating costs of operator1 + presow_till
03/Sep/1980,,0.25,2179.6612186022726,operating costs of operator1 + sowing
07/Sep/1980,,0.75,2178.9112186022726,operating costs of operator1 + weeding
30/Sep/1980,,0.75,2178.1612186022726,operating costs of operator1 + weeding
01/Oct/1980,,0.25,2177.9112186022726,operating costs of operator1 + weeding
09/Dec/1980,730.4709619431818,,2908.3821805454545,cropprice (maize)
09/Dec/1980,52.732493999999996,,2961.1146745454544,cropprice (maize_residue)
09/Dec/1980,,0.75,2960.3646745454544,operating costs of operator1 + harvesting
21/Dec/1980,0.0,,2960.3646745454544,cropprice (maize)
21/Dec/1980,15.095525568181818,,2975.4602001136363,cropprice (maize_residue)
21/Dec/1980,,0.25,2975.2102001136363,operating costs of operator1 + harvesting
18/Jan/1981,,0.75,2974.4602001136363,operating costs of operator1 + weeding
30/Jan/1981,,0.25,2974.2102001136363,operating costs of operator1 + weeding
15/Mar/1981,,31.5,2942.7102001136363,sowing costs
15/Mar/1981,,10.5,2932.2102001136363,sowing costs
15/Mar/1981,,0.75,2931.4602001136363,operating costs of operator1 + presow_till
16/Mar/1981,,0.75,2930.7102001136363,operating costs of operator1 + sowing
17/Mar/1981,,0.25,2930.4602001136363,operating costs of operator1 + presow_till
18/Mar/1981,,0.25,2930.2102001136363,operating costs of operator1 + sowing
14/Apr/1981,,0.75,2929.4602001136363,operating costs of operator1 + weeding
15/Apr/1981,,0.25,2929.2102001136363,operating costs of operator1 + weeding
25/Jun/1981,1182.5073851420455,,4111.717585255682,cropprice (bean)
25/Jun/1981,836.158811931818,,4947.8763971875,cropprice (maize)
25/Jun/1981,144.67081520454545,,5092.547212392045,cropprice (maize_residue)
25/Jun/1981,,0.75,5091.797212392045,operating costs of operator1 + harvesting
26/Jun/1981,,0.75,5091.047212392045,operating costs of operator1 + harvesting
30/Jun/1981,,606.1,4484.947212392045,Farm Overheads
06/Jul/1981,0.0,,4484.947212392045,cropprice (maize)
06/Jul/1981,14.30886147159091,,4499.256073863636,cropprice (maize_residue)
06/Jul/1981,,0.25,4499.006073863636,operating costs of operator1 + harvesting
04/Aug/1981,,0.75,4498.256073863636,operating costs of operator1 + weeding
15/Aug/1981,,0.25,4498.006073863636,operating costs of operator1 + weeding
01/Sep/1981,,15.0,4483.006073863636,sowing costs
01/Sep/1981,,5.0,4478.006073863636,sowing costs
01/Sep/1981,,0.75,4477.256073863636,operating costs of operator1 + presow_till
02/Sep/1981,,0.75,4476.506073863636,operating costs of operator1 + sowing
03/Sep/1981,,0.25,4476.256073863636,operating costs of operator1 + presow_till
04/Sep/1981,,0.25,4476.006073863636,operating costs of operator1 + sowing
01/Oct/1981,,0.75,4475.256073863636,operating costs of operator1 + weeding
02/Oct/1981,,0.25,4475.006073863636,operating costs of operator1 + weeding
11/Dec/1981,992.6528607997161,,5467.658934663352,cropprice (maize)
11/Dec/1981,81.18553578409092,,5548.844470447442,cropprice (maize_residue)
11/Dec/1981,,0.75,5548.094470447442,operating costs of operator1 + harvesting
27/Dec/1981,0.0,,5548.094470447442,cropprice (maize)
27/Dec/1981,12.55316578409091,,5560.647636231533,cropprice (maize_residue)
27/Dec/1981,,0.25,5560.397636231533,operating costs of operator1 + harvesting
20/Jan/1982,,0.75,5559.647636231533,operating costs of operator1 + weeding
05/Feb/1982,,0.25,5559.397636231533,operating costs of operator1 + weeding
23/Mar/1982,,31.5,5527.897636231533,sowing costs
23/Mar/1982,,10.5,5517.397636231533,sowing costs
23/Mar/1982,,0.75,5516.647636231533,operating costs of operator1 + presow_till
24/Mar/1982,,0.75,5515.897636231533,operating costs of operator1 + sowing
25/Mar/1982,,0.25,5515.647636231533,operating costs of operator1 + presow_till
26/Mar/1982,,0.25,5515.397636231533,operating costs of operator1 + sowing
22/Apr/1982,,0.75,5514.647636231533,operating costs of operator1 + weeding
23/Apr/1982,,0.25,5514.397636231533,operating costs of operator1 + weeding
30/Jun/1982,,606.1,4908.297636231533,Farm Overheads
01/Jul/1982,454.2302917329546,,5362.527927964487,cropprice (bean)
01/Jul/1982,1050.1490202954546,,6412.676948259942,cropprice (maize)
01/Jul/1982,124.58495261931822,,6537.26190087926,cropprice (maize_residue)
01/Jul/1982,219.79088339914773,,6757.052784278408,cropprice (maize)
01/Jul/1982,14.26664040340909,,6771.319424681817,cropprice (maize_residue)
01/Jul/1982,,0.75,6770.569424681817,operating costs of operator1 + harvesting
02/Jul/1982,,0.75,6769.819424681817,operating costs of operator1 + harvesting
03/Jul/1982,,0.25,6769.569424681817,operating costs of operator1 + harvesting
10/Aug/1982,,0.75,6768.819424681817,operating costs of operator1 + weeding
11/Aug/1982,,0.25,6768.569424681817,operating costs of operator1 + weeding
08/Sep/1982,,15.0,6753.569424681817,sowing costs
08/Sep/1982,,5.0,6748.569424681817,sowing costs
08/Sep/1982,,0.75,6747.819424681817,operating costs of operator1 + presow_till
09/Sep/1982,,0.75,6747.069424681817,operating costs of operator1 + sowing
10/Sep/1982,,0.25,6746.819424681817,operating costs of operator1 + presow_till
11/Sep/1982,,0.25,6746.569424681817,operating costs of operator1 + sowing
08/Oct/1982,,0.75,6745.819424681817,operating costs of operator1 + weeding
09/Oct/1982,,0.25,6745.569424681817,operating costs of operator1 + weeding
20/Dec/1982,784.683809705966,,7530.253234387783,cropprice (maize)
20/Dec/1982,60.62830977272726,,7590.88154416051,cropprice (maize_residue)
20/Dec/1982,,0.75,7590.13154416051,operating costs of operator1 + harvesting
24/Dec/1982,0.0,,7590.13154416051,cropprice (maize)
24/Dec/1982,20.08253894886364,,7610.214083109374,cropprice (maize_residue)
24/Dec/1982,,0.25,7609.964083109374,operating costs of operator1 + harvesting
29/Jan/1983,,0.75,7609.214083109374,operating costs of operator1 + weeding
02/Feb/1983,,0.25,7608.964083109374,operating costs of operator1 + weeding
16/Mar/1983,,31.5,7577.464083109374,sowing costs
16/Mar/1983,,10.5,7566.964083109374,sowing costs
16/Mar/1983,,0.75,7566.214083109374,operating costs of operator1 + presow_till
17/Mar/1983,,0.75,7565.464083109374,operating costs of operator1 + sowing
18/Mar/1983,,0.25,7565.214083109374,operating costs of operator1 + presow_till
19/Mar/1983,,0.25,7564.964083109374,operating costs of operator1 + sowing
15/Apr/1983,,0.75,7564.214083109374,operating costs of operator1 + weeding
16/Apr/1983,,0.25,7563.964083109374,operating costs of operator1 + weeding
18/Jun/1983,319.7666462215909,,7883.730729330965,cropprice (bean)
18/Jun/1983,893.1213671420455,,8776.85209647301,cropprice (maize)
18/Jun/1983,104.09582519318184,,8880.947921666193,cropprice (maize_residue)
18/Jun/1983,,0.75,8880.197921666193,operating costs of operator1 + harvesting
19/Jun/1983,,0.75,8879.447921666193,operating costs of operator1 + harvesting
26/Jun/1983,0.0,,8879.447921666193,cropprice (maize)
26/Jun/1983,15.236253215909093,,8894.684174882103,cropprice (maize_residue)
26/Jun/1983,,0.25,8894.434174882103,operating costs of operator1 + harvesting
30/Jun/1983,,606.1,8288.334174882102,Farm Overheads
28/Jul/1983,,0.75,8287.584174882102,operating costs of operator1 + weeding
05/Aug/1983,,0.25,8287.334174882102,operating costs of operator1 + weeding
01/Sep/1983,,15.0,8272.334174882102,sowing costs
01/Sep/1983,,5.0,8267.334174882102,sowing costs
01/Sep/1983,,0.75,8266.584174882102,operating costs of operator1 + presow_till
02/Sep/1983,,0.75,8265.834174882102,operating costs of operator1 + sowing
03/Sep/1983,,0.25,8265.584174882102,operating costs of operator1 + presow_till
04/Sep/1983,,0.25,8265.334174882102,operating costs of operator1 + sowing
01/Oct/1983,,0.75,8264.584174882102,operating costs of operator1 + weeding
02/Oct/1983,,0.25,8264.334174882102,operating costs of operator1 + weeding
12/Dec/1983,695.9195103068182,,8960.25368518892,cropprice (maize)
12/Dec/1983,51.30932340340908,,9011.56300859233,cropprice (maize_residue)
12/Dec/1983,,0.75,9010.81300859233,operating costs of operator1 + harvesting
28/Dec/1983,0.0,,9010.81300859233,cropprice (maize)
28/Dec/1983,12.411533704545455,,9023.224542296875,cropprice (maize_residue)
28/Dec/1983,,0.25,9022.974542296875,operating costs of operator1 + harvesting
21/Jan/1984,,0.75,9022.224542296875,operating costs of operator1 + weeding
06/Feb/1984,,0.25,9021.974542296875,operating costs of operator1 + weeding
14/Mar/1984,,31.5,8990.474542296875,sowing costs
14/Mar/1984,,10.5,8979.974542296875,sowing costs
14/Mar/1984,,0.75,8979.224542296875,operating costs of operator1 + presow_till
15/Mar/1984,,0.75,8978.474542296875,operating costs of operator1 + sowing
16/Mar/1984,,0.25,8978.224542296875,operating costs of operator1 + presow_till
17/Mar/1984,,0.25,8977.974542296875,operating costs of operator1 + sowing
13/Apr/1984,,0.75,8977.224542296875,operating costs of operator1 + weeding
14/Apr/1984,,0.25,8976.974542296875,operating costs of operator1 + weeding
18/Jun/1984,275.9673552443181,,9252.941897541194,cropprice (bean)
18/Jun/1984,985.0192182230113,,10237.961115764205,cropprice (maize)
18/Jun/1984,95.12360728977272,,10333.084723053977,cropprice (maize_residue)
18/Jun/1984,,0.75,10332.334723053977,operating costs of operator1 + harvesting
19/Jun/1984,,0.75,10331.584723053977,operating costs of operator1 + harvesting
20/Jun/1984,130.10896188920455,,10461.69368494318,cropprice (maize)
20/Jun/1984,15.875183107954546,,10477.568868051136,cropprice (maize_residue)
20/Jun/1984,,0.25,10477.318868051136,operating costs of operator1 + harvesting
29/Jun/1984,,606.1,9871.218868051135,Farm Overheads
28/Jul/1984,,0.75,9870.468868051135,operating costs of operator1 + weeding
30/Jul/1984,,0.25,9870.218868051135,operating costs of operator1 + weeding
30/Aug/1984,,15.0,9855.218868051135,sowing costs
30/Aug/1984,,5.0,9850.218868051135,sowing costs
30/Aug/1984,,0.75,9849.468868051135,operating costs of operator1 + presow_till
31/Aug/1984,,0.75,9848.718868051135,operating costs of operator1 + sowing
01/Sep/1984,,0.25,9848.468868051135,operating costs of operator1 + presow_till
02/Sep/1984,,0.25,9848.218868051135,operating costs of operator1 + sowing
29/Sep/1984,,0.75,9847.468868051135,operating costs of operator1 + weeding
30/Sep/1984,,0.25,9847.218868051135,operating costs of operator1 + weeding
09/Dec/1984,523.4733475184661,,10370.692215569601,cropprice (maize)
09/Dec/1984,48.01855191477272,,10418.710767484374,cropprice (maize_residue)
09/Dec/1984,,0.75,10417.960767484374,operating costs of operator1 + harvesting
10/Dec/1984,75.59518764630683,,10493.55595513068,cropprice (maize)
10/Dec/1984,18.891479494318183,,10512.447434624997,cropprice (maize_residue)
10/Dec/1984,,0.25,10512.197434624997,operating costs of operator1 + harvesting
18/Jan/1985,,0.75,10511.447434624997,operating costs of operator1 + weeding
19/Jan/1985,,0.25,10511.197434624997,operating costs of operator1 + weeding
20/Mar/1985,,31.5,10479.697434624997,sowing costs
20/Mar/1985,,10.5,10469.197434624997,sowing costs
20/Mar/1985,,0.75,10468.447434624997,operating costs of operator1 + presow_till
21/Mar/1985,,0.75,10467.697434624997,operating costs of operator1 + sowing
22/Mar/1985,,0.25,10467.447434624997,operating costs of operator1 + presow_till
23/Mar/1985,,0.25,10467.197434624997,operating costs of operator1 + sowing
19/Apr/1985,,0.75,10466.447434624997,operating costs of operator1 + weeding
20/Apr/1985,,0.25,10466.197434624997,operating costs of operator1 + weeding
30/Jun/1985,,606.1,9860.097434624997,Farm Overheads
05/Jul/1985,2213.738425380682,,12073.835860005678,cropprice (bean)
05/Jul/1985,0.0,,12073.835860005678,cropprice (maize)
05/Jul/1985,191.86227139772723,,12265.698131403406,cropprice (maize_residue)
05/Jul/1985,0.0,,12265.698131403406,cropprice (maize)
05/Jul/1985,19.091061676136363,,12284.789193079541,cropprice (maize_residue)
05/Jul/1985,,0.75,12284.039193079541,operating costs of operator1 + harvesting
06/Jul/1985,,0.75,12283.289193079541,operating costs of operator1 + harvesting
07/Jul/1985,,0.25,12283.039193079541,operating costs of operator1 + harvesting
14/Aug/1985,,0.75,12282.289193079541,operating costs of operator1 + weeding
15/Aug/1985,,0.25,12282.039193079541,operating costs of operator1 + weeding
01/Sep/1985,,15.0,12267.039193079541,sowing costs
01/Sep/1985,,5.0,12262.039193079541,sowing costs
01/Sep/1985,,0.75,12261.289193079541,operating costs of operator1 + presow_till
02/Sep/1985,,0.75,12260.539193079541,operating costs of operator1 + sowing
03/Sep/1985,,0.25,12260.289193079541,operating costs of operator1 + presow_till
04/Sep/1985,,0.25,12260.039193079541,operating costs of operator1 + sowing
01/Oct/1985,,0.75,12259.289193079541,operating costs of operator1 + weeding
02/Oct/1985,,0.25,12259.039193079541,operating costs of operator1 + weeding
13/Dec/1985,35.76034196590909,,12294.799535045451,cropprice (maize)
13/Dec/1985,60.91921442045455,,12355.718749465907,cropprice (maize_residue)
13/Dec/1985,,0.75,12354.968749465907,operating costs of operator1 + harvesting
29/Dec/1985,0.0,,12354.968749465907,cropprice (maize)
29/Dec/1985,6.449107778409092,,12361.417857244316,cropprice (maize_residue)
29/Dec/1985,,0.25,12361.167857244316,operating costs of operator1 + harvesting
22/Jan/1986,,0.75,12360.417857244316,operating costs of operator1 + weeding
07/Feb/1986,,0.25,12360.167857244316,operating costs of operator1 + weeding
21/Mar/1986,,31.5,12328.667857244316,sowing costs
21/Mar/1986,,10.5,12318.167857244316,sowing costs
21/Mar/1986,,0.75,12317.417857244316,operating costs of operator1 + presow_till
22/Mar/1986,,0.75,12316.667857244316,operating costs of operator1 + sowing
23/Mar/1986,,0.25,12316.417857244316,operating costs of operator1 + presow_till
24/Mar/1986,,0.25,12316.167857244316,operating costs of operator1 + sowing
20/Apr/1986,,0.75,12315.417857244316,operating costs of operator1 + weeding
21/Apr/1986,,0.25,12315.167857244316,operating costs of operator1 + weeding
30/Jun/1986,,606.1,11709.067857244316,Farm Overheads
01/Jul/1986,952.2006018238638,,12661.26845906818,cropprice (bean)
01/Jul/1986,802.0102241505682,,13463.278683218748,cropprice (maize)
01/Jul/1986,132.51038984659093,,13595.78907306534,cropprice (maize_residue)
01/Jul/1986,,0.75,13595.03907306534,operating costs of operator1 + harvesting
02/Jul/1986,110.40372507102272,,13705.442798136362,cropprice (maize)
02/Jul/1986,17.86793656818182,,13723.310734704544,cropprice (maize_residue)
02/Jul/1986,,0.75,13722.560734704544,operating costs of operator1 + harvesting
03/Jul/1986,,0.25,13722.310734704544,operating costs of operator1 + harvesting
10/Aug/1986,,0.75,13721.560734704544,operating costs of operator1 + weeding
11/Aug/1986,,0.25,13721.310734704544,operating costs of operator1 + weeding
02/Sep/1986,,15.0,13706.310734704544,sowing costs
02/Sep/1986,,5.0,13701.310734704544,sowing costs
02/Sep/1986,,0.75,13700.560734704544,operating costs of operator1 + presow_till
03/Sep/1986,,0.75,13699.810734704544,operating costs of operator1 + sowing
04/Sep/1986,,0.25,13699.560734704544,operating costs of operator1 + presow_till
05/Sep/1986,,0.25,13699.310734704544,operating costs of operator1 + sowing
02/Oct/1986,,0.75,13698.560734704544,operating costs of operator1 + weeding
03/Oct/1986,,0.25,13698.310734704544,operating costs of operator1 + weeding
11/Dec/1986,1033.68534384375,,14731.996078548294,cropprice (maize)
11/Dec/1986,81.67605867613636,,14813.67213722443,cropprice (maize_residue)
11/Dec/1986,,0.75,14812.92213722443,operating costs of operator1 + harvesting
18/Dec/1986,0.0,,14812.92213722443,cropprice (maize)
18/Dec/1986,17.93238136931818,,14830.85451859375,cropprice (maize_residue)
18/Dec/1986,,0.25,14830.60451859375,operating costs of operator1 + harvesting
20/Jan/1987,,0.75,14829.85451859375,operating costs of operator1 + weeding
27/Jan/1987,,0.25,14829.60451859375,operating costs of operator1 + weeding
16/Mar/1987,,31.5,14798.10451859375,sowing costs
16/Mar/1987,,10.5,14787.60451859375,sowing costs
16/Mar/1987,,0.75,14786.85451859375,operating costs of operator1 + presow_till
17/Mar/1987,,0.75,14786.10451859375,operating costs of operator1 + sowing
18/Mar/1987,,0.25,14785.85451859375,operating costs of operator1 + presow_till
19/Mar/1987,,0.25,14785.60451859375,operating costs of operator1 + sowing
15/Apr/1987,,0.75,14784.85451859375,operating costs of operator1 + weeding
16/Apr/1987,,0.25,14784.60451859375,operating costs of operator1 + weeding
22/Jun/1987,669.1478262954547,,15453.752344889204,cropprice (bean)
22/Jun/1987,795.7879924985796,,16249.540337387783,cropprice (maize)
22/Jun/1987,126.25663895454545,,16375.796976342328,cropprice (maize_residue)
22/Jun/1987,,0.75,16375.046976342328,operating costs of operator1 + harvesting
23/Jun/1987,,0.75,16374.296976342328,operating costs of operator1 + harvesting
30/Jun/1987,,606.1,15768.196976342328,Farm Overheads
06/Jul/1987,0.0,,15768.196976342328,cropprice (maize)
06/Jul/1987,14.496731846590906,,15782.69370818892,cropprice (maize_residue)
06/Jul/1987,,0.25,15782.44370818892,operating costs of operator1 + harvesting
01/Aug/1987,,0.75,15781.69370818892,operating costs of operator1 + weeding
15/Aug/1987,,0.25,15781.44370818892,operating costs of operator1 + weeding
09/Sep/1987,,15.0,15766.44370818892,sowing costs
09/Sep/1987,,5.0,15761.44370818892,sowing costs
09/Sep/1987,,0.75,15760.69370818892,operating costs of operator1 + presow_till
10/Sep/1987,,0.75,15759.94370818892,operating costs of operator1 + sowing
11/Sep/1987,,0.25,15759.69370818892,operating costs of operator1 + presow_till
12/Sep/1987,,0.25,15759.44370818892,operating costs of operator1 + sowing
09/Oct/1987,,0.75,15758.69370818892,operating costs of operator1 + weeding
10/Oct/1987,,0.25,15758.44370818892,operating costs of operator1 + weeding
17/Dec/1987,1077.8248708977274,,16836.268579086645,cropprice (maize)
17/Dec/1987,97.78988093181817,,16934.058460018463,cropprice (maize_residue)
17/Dec/1987,,0.75,16933.308460018463,operating costs of operator1 + harvesting
30/Dec/1987,0.0,,16933.308460018463,cropprice (maize)
30/Dec/1987,14.389848187499998,,16947.698308205963,cropprice (maize_residue)
30/Dec/1987,,0.25,16947.448308205963,operating costs of operator1 + harvesting
26/Jan/1988,,0.75,16946.698308205963,operating costs of operator1 + weeding
08/Feb/1988,,0.25,16946.448308205963,operating costs of operator1 + weeding
17/Mar/1988,,31.5,16914.948308205963,sowing costs
17/Mar/1988,,10.5,16904.448308205963,sowing costs
17/Mar/1988,,0.75,16903.698308205963,operating costs of operator1 + presow_till
18/Mar/1988,,0.75,16902.948308205963,operating costs of operator1 + sowing
19/Mar/1988,,0.25,16902.698308205963,operating costs of operator1 + presow_till
20/Mar/1988,,0.25,16902.448308205963,operating costs of operator1 + sowing
16/Apr/1988,,0.75,16901.698308205963,operating costs of operator1 + weeding
17/Apr/1988,,0.25,16901.448308205963,operating costs of operator1 + weeding
26/Jun/1988,1750.2107099829545,,18651.65901818892,cropprice (bean)
26/Jun/1988,384.19845018749993,,19035.85746837642,cropprice (maize)
26/Jun/1988,205.9666858977273,,19241.82415427415,cropprice (maize_residue)
26/Jun/1988,,0.75,19241.07415427415,operating costs of operator1 + harvesting
27/Jun/1988,,0.75,19240.32415427415,operating costs of operator1 + harvesting
29/Jun/1988,,606.1,18634.22415427415,Farm Overheads
08/Jul/1988,0.0,,18634.22415427415,cropprice (maize)
08/Jul/1988,14.820082232954546,,18649.044236507107,cropprice (maize_residue)
08/Jul/1988,,0.25,18648.794236507107,operating costs of operator1 + harvesting
05/Aug/1988,,0.75,18648.044236507107,operating costs of operator1 + weeding
17/Aug/1988,,0.25,18647.794236507107,operating costs of operator1 + weeding
30/Aug/1988,,15.0,18632.794236507107,sowing costs
30/Aug/1988,,5.0,18627.794236507107,sowing costs
30/Aug/1988,,0.75,18627.044236507107,operating costs of operator1 + presow_till
31/Aug/1988,,0.75,18626.294236507107,operating costs of operator1 + sowing
01/Sep/1988,,0.25,18626.044236507107,operating costs of operator1 + presow_till
02/Sep/1988,,0.25,18625.794236507107,operating costs of operator1 + sowing
29/Sep/1988,,0.75,18625.044236507107,operating costs of operator1 + weeding
30/Sep/1988,,0.25,18624.794236507107,operating costs of operator1 + weeding
11/Dec/1988,1074.0234979048294,,19698.817734411936,cropprice (maize)
11/Dec/1988,93.15944325,,19791.977177661935,cropprice (maize_residue)
11/Dec/1988,,0.75,19791.227177661935,operating costs of operator1 + harvesting
01/Jan/1989,0.0,,19791.227177661935,cropprice (maize)
01/Jan/1989,9.903152465909091,,19801.130330127842,cropprice (maize_residue)
01/Jan/1989,,0.25,19800.880330127842,operating costs of operator1 + harvesting
20/Jan/1989,,0.75,19800.130330127842,operating costs of operator1 + weeding
10/Feb/1989,,0.25,19799.880330127842,operating costs of operator1 + weeding
15/Mar/1989,,31.5,19768.380330127842,sowing costs
15/Mar/1989,,10.5,19757.880330127842,sowing costs
15/Mar/1989,,0.75,19757.130330127842,operating costs of operator1 + presow_till
16/Mar/1989,,0.75,19756.380330127842,operating costs of operator1 + sowing
17/Mar/1989,,0.25,19756.130330127842,operating costs of operator1 + presow_till
18/Mar/1989,,0.25,19755.880330127842,operating costs of operator1 + sowing
14/Apr/1989,,0.75,19755.130330127842,operating costs of operator1 + weeding
15/Apr/1989,,0.25,19754.880330127842,operating costs of operator1 + weeding
27/Jun/1989,1246.8718248238636,,21001.752154951704,cropprice (bean)
27/Jun/1989,630.2381487059658,,21631.99030365767,cropprice (maize)
27/Jun/1989,149.84336159659088,,21781.83366525426,cropprice (maize_residue)
27/Jun/1989,,0.75,21781.08366525426,operating costs of operator1 + harvesting
28/Jun/1989,,0.75,21780.33366525426,operating costs of operator1 + harvesting
30/Jun/1989,,606.1,21174.23366525426,Farm Overheads
13/Jul/1989,0.0,,21174.23366525426,cropprice (maize)
13/Jul/1989,12.76381891477273,,21186.997484169035,cropprice (maize_residue)
13/Jul/1989,,0.25,21186.747484169035,operating costs of operator1 + harvesting
06/Aug/1989,,0.75,21185.997484169035,operating costs of operator1 + weeding
22/Aug/1989,,0.25,21185.747484169035,operating costs of operator1 + weeding
01/Sep/1989,,15.0,21170.747484169035,sowing costs
01/Sep/1989,,5.0,21165.747484169035,sowing costs
01/Sep/1989,,0.75,21164.997484169035,operating costs of operator1 + presow_till
02/Sep/1989,,0.75,21164.247484169035,operating costs of operator1 + sowing
03/Sep/1989,,0.25,21163.997484169035,operating costs of operator1 + presow_till
04/Sep/1989,,0.25,21163.747484169035,operating costs of operator1 + sowing
01/Oct/1989,,0.75,21162.997484169035,operating costs of operator1 + weeding
02/Oct/1989,,0.25,21162.747484169035,operating costs of operator1 + weeding
11/Dec/1989,994.9107421278411,,22157.658226296877,cropprice (maize)
11/Dec/1989,80.5803139431818,,22238.238540240058,cropprice (maize_residue)
11/Dec/1989,,0.75,22237.488540240058,operating costs of operator1 + harvesting
30/Dec/1989,0.0,,22237.488540240058,cropprice (maize)
30/Dec/1989,9.8888785625,,22247.377418802556,cropprice (maize_residue)
30/Dec/1989,,0.25,22247.127418802556,operating costs of operator1 + harvesting
20/Jan/1990,,0.75,22246.377418802556,operating costs of operator1 + weeding
08/Feb/1990,,0.25,22246.127418802556,operating costs of operator1 + weeding
15/Mar/1990,,31.5,22214.627418802556,sowing costs
15/Mar/1990,,10.5,22204.127418802556,sowing costs
15/Mar/1990,,0.75,22203.377418802556,operating costs of operator1 + presow_till
16/Mar/1990,,0.75,22202.627418802556,operating costs of operator1 + sowing
17/Mar/1990,,0.25,22202.377418802556,operating costs of operator1 + presow_till
18/Mar/1990,,0.25,22202.127418802556,operating costs of operator1 + sowing
14/Apr/1990,,0.75,22201.377418802556,operating costs of operator1 + weeding
15/Apr/1990,,0.25,22201.127418802556,operating costs of operator1 + weeding
24/Jun/1990,862.1704890511364,,23063.297907853692,cropprice (bean)
24/Jun/1990,797.7195273707389,,23861.017435224432,cropprice (maize)
24/Jun/1990,127.39099397727273,,23988.408429201703,cropprice (maize_residue)
24/Jun/1990,,0.75,23987.658429201703,operating costs of operator1 + harvesting
25/Jun/1990,,0.75,23986.908429201703,operating costs of operator1 + harvesting
30/Jun/1990,,606.1,23380.808429201705,Farm Overheads
05/Jul/1990,0.0,,23380.808429201705,cropprice (maize)
05/Jul/1990,13.369703812500003,,23394.178133014204,cropprice (maize_residue)
05/Jul/1990,,0.25,23393.928133014204,operating costs of operator1 + harvesting
03/Aug/1990,,0.75,23393.178133014204,operating costs of operator1 + weeding
14/Aug/1990,,0.25,23392.928133014204,operating costs of operator1 + weeding
01/Sep/1990,,15.0,23377.928133014204,sowing costs
01/Sep/1990,,5.0,23372.928133014204,sowing costs
01/Sep/1990,,0.75,23372.178133014204,operating costs of operator1 + presow_till
02/Sep/1990,,0.75,23371.428133014204,operating costs of operator1 + sowing
03/Sep/1990,,0.25,23371.178133014204,operating costs of operator1 + presow_till
04/Sep/1990,,0.25,23370.928133014204,operating costs of operator1 + sowing
01/Oct/1990,,0.75,23370.178133014204,operating costs of operator1 + weeding
02/Oct/1990,,0.25,23369.928133014204,operating costs of operator1 + weeding
14/Dec/1990,873.7923918579545,,24243.72052487216,cropprice (maize)
14/Dec/1990,70.26938698295454,,24313.989911855115,cropprice (maize_residue)
14/Dec/1990,,0.75,24313.239911855115,operating costs of operator1 + harvesting
02/Jan/1991,0.0,,24313.239911855115,cropprice (maize)
02/Jan/1991,11.876456522727272,,24325.116368377843,cropprice (maize_residue)
02/Jan/1991,,0.25,24324.866368377843,operating costs of operator1 + harvesting
23/Jan/1991,,0.75,24324.116368377843,operating costs of operator1 + weeding
11/Feb/1991,,0.25,24323.866368377843,operating costs of operator1 + weeding
27/Mar/1991,,31.5,24292.366368377843,sowing costs
27/Mar/1991,,10.5,24281.866368377843,sowing costs
27/Mar/1991,,0.75,24281.116368377843,operating costs of operator1 + presow_till
28/Mar/1991,,0.75,24280.366368377843,operating costs of operator1 + sowing
29/Mar/1991,,0.25,24280.116368377843,operating costs of operator1 + presow_till
30/Mar/1991,,0.25,24279.866368377843,operating costs of operator1 + sowing
26/Apr/1991,,0.75,24279.116368377843,operating costs of operator1 + weeding
27/Apr/1991,,0.25,24278.866368377843,operating costs of operator1 + weeding
30/Jun/1991,,606.1,23672.766368377845,Farm Overheads
06/Jul/1991,963.2274545965909,,24635.993822974437,cropprice (bean)
06/Jul/1991,796.4974649403409,,25432.491287914778,cropprice (maize)
06/Jul/1991,132.04875599999997,,25564.540043914778,cropprice (maize_residue)
06/Jul/1991,,0.75,25563.790043914778,operating costs of operator1 + harvesting
07/Jul/1991,,0.75,25563.040043914778,operating costs of operator1 + harvesting
13/Jul/1991,0.0,,25563.040043914778,cropprice (maize)
13/Jul/1991,15.174371892045455,,25578.214415806822,cropprice (maize_residue)
13/Jul/1991,,0.25,25577.964415806822,operating costs of operator1 + harvesting
15/Aug/1991,,0.75,25577.214415806822,operating costs of operator1 + weeding
22/Aug/1991,,0.25,25576.964415806822,operating costs of operator1 + weeding
02/Sep/1991,,15.0,25561.964415806822,sowing costs
02/Sep/1991,,5.0,25556.964415806822,sowing costs
02/Sep/1991,,0.75,25556.214415806822,operating costs of operator1 + presow_till
03/Sep/1991,,0.75,25555.464415806822,operating costs of operator1 + sowing
04/Sep/1991,,0.25,25555.214415806822,operating costs of operator1 + presow_till
05/Sep/1991,,0.25,25554.964415806822,operating costs of operator1 + sowing
02/Oct/1991,,0.75,25554.214415806822,operating costs of operator1 + weeding
03/Oct/1991,,0.25,25553.964415806822,operating costs of operator1 + weeding
13/Dec/1991,938.4799619403409,,26492.444377747164,cropprice (maize)
13/Dec/1991,65.70638205681819,,26558.150759803983,cropprice (maize_residue)
13/Dec/1991,,0.75,26557.400759803983,operating costs of operator1 + harvesting
02/Jan/1992,0.0,,26557.400759803983,cropprice (maize)
02/Jan/1992,9.343941426136364,,26566.74470123012,cropprice (maize_residue)
02/Jan/1992,,0.25,26566.49470123012,operating costs of operator1 + harvesting
22/Jan/1992,,0.75,26565.74470123012,operating costs of operator1 + weeding
11/Feb/1992,,0.25,26565.49470123012,operating costs of operator1 + weeding
01/Apr/1992,,31.5,26533.99470123012,sowing costs
01/Apr/1992,,10.5,26523.49470123012,sowing costs
01/Apr/1992,,0.75,26522.74470123012,operating costs of operator1 + presow_till
02/Apr/1992,,0.75,26521.99470123012,operating costs of operator1 + sowing
03/Apr/1992,,0.25,26521.74470123012,operating costs of operator1 + presow_till
04/Apr/1992,,0.25,26521.49470123012,operating costs of operator1 + sowing
01/May/1992,,0.75,26520.74470123012,operating costs of operator1 + weeding
02/May/1992,,0.25,26520.49470123012,operating costs of operator1 + weeding
29/Jun/1992,,606.1,25914.39470123012,Farm Overheads
11/Jul/1992,885.9028056136364,,26800.29750684376,cropprice (bean)
11/Jul/1992,951.2314018210227,,27751.528908664783,cropprice (maize)
11/Jul/1992,138.2731101306818,,27889.802018795464,cropprice (maize_residue)
11/Jul/1992,,0.75,27889.052018795464,operating costs of operator1 + harvesting
12/Jul/1992,93.21973038920454,,27982.27174918467,cropprice (maize)
12/Jul/1992,17.38669100568182,,27999.658440190353,cropprice (maize_residue)
12/Jul/1992,,0.75,27998.908440190353,operating costs of operator1 + harvesting
13/Jul/1992,,0.25,27998.658440190353,operating costs of operator1 + harvesting
20/Aug/1992,,0.75,27997.908440190353,operating costs of operator1 + weeding
21/Aug/1992,,0.25,27997.658440190353,operating costs of operator1 + weeding
31/Aug/1992,,15.0,27982.658440190353,sowing costs
31/Aug/1992,,5.0,27977.658440190353,sowing costs
31/Aug/1992,,0.75,27976.908440190353,operating costs of operator1 + presow_till
01/Sep/1992,,0.75,27976.158440190353,operating costs of operator1 + sowing
02/Sep/1992,,0.25,27975.908440190353,operating costs of operator1 + presow_till
03/Sep/1992,,0.25,27975.658440190353,operating costs of operator1 + sowing
30/Sep/1992,,0.75,27974.908440190353,operating costs of operator1 + weeding
01/Oct/1992,,0.25,27974.658440190353,operating costs of operator1 + weeding
13/Dec/1992,769.9208735071024,,28744.579313697453,cropprice (maize)
13/Dec/1992,56.63849154545454,,28801.217805242908,cropprice (maize_residue)
13/Dec/1992,,0.75,28800.467805242908,operating costs of operator1 + harvesting
30/Dec/1992,0.0,,28800.467805242908,cropprice (maize)
30/Dec/1992,13.769016613636362,,28814.236821856546,cropprice (maize_residue)
30/Dec/1992,,0.25,28813.986821856546,operating costs of operator1 + harvesting
22/Jan/1993,,0.75,28813.236821856546,operating costs of operator1 + weeding
08/Feb/1993,,0.25,28812.986821856546,operating costs of operator1 + weeding
15/Mar/1993,,31.5,28781.486821856546,sowing costs
15/Mar/1993,,10.5,28770.986821856546,sowing costs
15/Mar/1993,,0.75,28770.236821856546,operating costs of operator1 + presow_till
16/Mar/1993,,0.75,28769.486821856546,operating costs of operator1 + sowing
17/Mar/1993,,0.25,28769.236821856546,operating costs of operator1 + presow_till
18/Mar/1993,,0.25,28768.986821856546,operating costs of operator1 + sowing
14/Apr/1993,,0.75,28768.236821856546,operating costs of operator1 + weeding
15/Apr/1993,,0.25,28767.986821856546,operating costs of operator1 + weeding
20/Jun/1993,899.0621793920457,,29667.049001248593,cropprice (bean)
20/Jun/1993,632.9275531491478,,30299.97655439774,cropprice (maize)
20/Jun/1993,160.59891023863636,,30460.57546463638,cropprice (maize_residue)
20/Jun/1993,,0.75,30459.82546463638,operating costs of operator1 + harvesting
21/Jun/1993,,0.75,30459.07546463638,operating costs of operator1 + harvesting
30/Jun/1993,,606.1,29852.97546463638,Farm Overheads
04/Jul/1993,0.0,,29852.97546463638,cropprice (maize)
04/Jul/1993,13.389162931818179,,29866.364627568197,cropprice (maize_residue)
04/Jul/1993,,0.25,29866.114627568197,operating costs of operator1 + harvesting
30/Jul/1993,,0.75,29865.364627568197,operating costs of operator1 + weeding
13/Aug/1993,,0.25,29865.114627568197,operating costs of operator1 + weeding
05/Sep/1993,,15.0,29850.114627568197,sowing costs
05/Sep/1993,,5.0,29845.114627568197,sowing costs
05/Sep/1993,,0.75,29844.364627568197,operating costs of operator1 + presow_till
06/Sep/1993,,0.75,29843.614627568197,operating costs of operator1 + sowing
07/Sep/1993,,0.25,29843.364627568197,operating costs of operator1 + presow_till
08/Sep/1993,,0.25,29843.114627568197,operating costs of operator1 + sowing
05/Oct/1993,,0.75,29842.364627568197,operating costs of operator1 + weeding
06/Oct/1993,,0.25,29842.114627568197,operating costs of operator1 + weeding
13/Dec/1993,1037.3204596576704,,30879.435087225866,cropprice (maize)
13/Dec/1993,81.29552389772728,,30960.730611123592,cropprice (maize_residue)
13/Dec/1993,,0.75,30959.980611123592,operating costs of operator1 + harvesting
31/Dec/1993,0.0,,30959.980611123592,cropprice (maize)
31/Dec/1993,10.428580545454547,,30970.409191669045,cropprice (maize_residue)
31/Dec/1993,,0.25,30970.159191669045,operating costs of operator1 + harvesting
22/Jan/1994,,0.75,30969.409191669045,operating costs of operator1 + weeding
09/Feb/1994,,0.25,30969.159191669045,operating costs of operator1 + weeding
18/Mar/1994,,31.5,30937.659191669045,sowing costs
18/Mar/1994,,10.5,30927.159191669045,sowing costs
18/Mar/1994,,0.75,30926.409191669045,operating costs of operator1 + presow_till
19/Mar/1994,,0.75,30925.659191669045,operating costs of operator1 + sowing
20/Mar/1994,,0.25,30925.409191669045,operating costs of operator1 + presow_till
21/Mar/1994,,0.25,30925.159191669045,operating costs of operator1 + sowing
17/Apr/1994,,0.75,30924.409191669045,operating costs of operator1 + weeding
18/Apr/1994,,0.25,30924.159191669045,operating costs of operator1 + weeding
28/Jun/1994,1592.4604213636367,,32516.619613032683,cropprice (bean)
28/Jun/1994,295.93750944886364,,32812.55712248154,cropprice (maize)
28/Jun/1994,200.00638649999996,,33012.56350898154,cropprice (maize_residue)
28/Jun/1994,,0.75,33011.81350898154,operating costs of operator1 + harvesting
29/Jun/1994,,0.75,33011.06350898154,operating costs of operator1 + harvesting
30/Jun/1994,,606.1,32404.963508981542,Farm Overheads
05/Jul/1994,0.0,,32404.963508981542,cropprice (maize)
05/Jul/1994,15.301182142045455,,32420.264691123586,cropprice (maize_residue)
05/Jul/1994,,0.25,32420.014691123586,operating costs of operator1 + harvesting
07/Aug/1994,,0.75,32419.264691123586,operating costs of operator1 + weeding
14/Aug/1994,,0.25,32419.014691123586,operating costs of operator1 + weeding
01/Sep/1994,,15.0,32404.014691123586,sowing costs
01/Sep/1994,,5.0,32399.014691123586,sowing costs
01/Sep/1994,,0.75,32398.264691123586,operating costs of operator1 + presow_till
02/Sep/1994,,0.75,32397.514691123586,operating costs of operator1 + sowing
03/Sep/1994,,0.25,32397.264691123586,operating costs of operator1 + presow_till
04/Sep/1994,,0.25,32397.014691123586,operating costs of operator1 + sowing
01/Oct/1994,,0.75,32396.264691123586,operating costs of operator1 + weeding
02/Oct/1994,,0.25,32396.014691123586,operating costs of operator1 + weeding
10/Dec/1994,1062.1957873934657,,33458.21047851705,cropprice (maize)
10/Dec/1994,96.29760465340911,,33554.50808317046,cropprice (maize_residue)
10/Dec/1994,,0.75,33553.75808317046,operating costs of operator1 + harvesting
31/Dec/1994,0.0,,33553.75808317046,cropprice (maize)
31/Dec/1994,9.193326085227273,,33562.951409255686,cropprice (maize_residue)
31/Dec/1994,,0.25,33562.701409255686,operating costs of operator1 + harvesting
19/Jan/1995,,0.75,33561.951409255686,operating costs of operator1 + weeding
09/Feb/1995,,0.25,33561.701409255686,operating costs of operator1 + weeding
15/Mar/1995,,31.5,33530.201409255686,sowing costs
15/Mar/1995,,10.5,33519.701409255686,sowing costs
15/Mar/1995,,0.75,33518.951409255686,operating costs of operator1 + presow_till
16/Mar/1995,,0.75,33518.201409255686,operating costs of operator1 + sowing
17/Mar/1995,,0.25,33517.951409255686,operating costs of operator1 + presow_till
18/Mar/1995,,0.25,33517.701409255686,operating costs of operator1 + sowing
14/Apr/1995,,0.75,33516.951409255686,operating costs of operator1 + weeding
15/Apr/1995,,0.25,33516.701409255686,operating costs of operator1 + weeding
20/Jun/1995,664.2120125454546,,34180.91342180114,cropprice (bean)
20/Jun/1995,900.5025136448864,,35081.41593544603,cropprice (maize)
20/Jun/1995,137.21116499999997,,35218.62710044603,cropprice (maize_residue)
20/Jun/1995,,0.75,35217.87710044603,operating costs of operator1 + harvesting
21/Jun/1995,,0.75,35217.12710044603,operating costs of operator1 + harvesting
30/Jun/1995,,606.1,34611.02710044603,Farm Overheads
07/Jul/1995,0.0,,34611.02710044603,cropprice (maize)
07/Jul/1995,10.836919613636361,,34621.864020059664,cropprice (maize_residue)
07/Jul/1995,,0.25,34621.614020059664,operating costs of operator1 + harvesting
30/Jul/1995,,0.75,34620.864020059664,operating costs of operator1 + weeding
16/Aug/1995,,0.25,34620.614020059664,operating costs of operator1 + weeding
03/Sep/1995,,15.0,34605.614020059664,sowing costs
03/Sep/1995,,5.0,34600.614020059664,sowing costs
03/Sep/1995,,0.75,34599.864020059664,operating costs of operator1 + presow_till
04/Sep/1995,,0.75,34599.114020059664,operating costs of operator1 + sowing
05/Sep/1995,,0.25,34598.864020059664,operating costs of operator1 + presow_till
06/Sep/1995,,0.25,34598.614020059664,operating costs of operator1 + sowing
03/Oct/1995,,0.75,34597.864020059664,operating costs of operator1 + weeding
04/Oct/1995,,0.25,34597.614020059664,operating costs of operator1 + weeding
15/Dec/1995,1037.775892896307,,35635.38991295597,cropprice (maize)
15/Dec/1995,87.04303810227273,,35722.43295105825,cropprice (maize_residue)
15/Dec/1995,,0.75,35721.68295105825,operating costs of operator1 + harvesting
02/Jan/1996,0.0,,35721.68295105825,cropprice (maize)
02/Jan/1996,11.19508500568182,,35732.87803606393,cropprice (maize_residue)
02/Jan/1996,,0.25,35732.62803606393,operating costs of operator1 + harvesting
24/Jan/1996,,0.75,35731.87803606393,operating costs of operator1 + weeding
11/Feb/1996,,0.25,35731.62803606393,operating costs of operator1 + weeding
20/Mar/1996,,31.5,35700.12803606393,sowing costs
20/Mar/1996,,10.5,35689.62803606393,sowing costs
20/Mar/1996,,0.75,35688.87803606393,operating costs of operator1 + presow_till
21/Mar/1996,,0.75,35688.12803606393,operating costs of operator1 + sowing
22/Mar/1996,,0.25,35687.87803606393,operating costs of operator1 + presow_till
23/Mar/1996,,0.25,35687.62803606393,operating costs of operator1 + sowing
19/Apr/1996,,0.75,35686.87803606393,operating costs of operator1 + weeding
20/Apr/1996,,0.25,35686.62803606393,operating costs of operator1 + weeding
29/Jun/1996,1381.9912759943181,,37068.61931205825,cropprice (bean)
29/Jun/1996,383.74383041335227,,37452.3631424716,cropprice (maize)
29/Jun/1996,182.4039084715909,,37634.76705094319,cropprice (maize_residue)
29/Jun/1996,,0.75,37634.01705094319,operating costs of operator1 + harvesting
29/Jun/1996,,606.1,37027.91705094319,Farm Overheads
30/Jun/1996,,0.75,37027.16705094319,operating costs of operator1 + harvesting
13/Jul/1996,0.0,,37027.16705094319,cropprice (maize)
13/Jul/1996,12.660070244318183,,37039.82712118751,cropprice (maize_residue)
13/Jul/1996,,0.25,37039.57712118751,operating costs of operator1 + harvesting
08/Aug/1996,,0.75,37038.82712118751,operating costs of operator1 + weeding
22/Aug/1996,,0.25,37038.57712118751,operating costs of operator1 + weeding
30/Aug/1996,,15.0,37023.57712118751,sowing costs
30/Aug/1996,,5.0,37018.57712118751,sowing costs
30/Aug/1996,,0.75,37017.82712118751,operating costs of operator1 + presow_till
31/Aug/1996,,0.75,37017.07712118751,operating costs of operator1 + sowing
01/Sep/1996,,0.25,37016.82712118751,operating costs of operator1 + presow_till
02/Sep/1996,,0.25,37016.57712118751,operating costs of operator1 + sowing
29/Sep/1996,,0.75,37015.82712118751,operating costs of operator1 + weeding
30/Sep/1996,,0.25,37015.57712118751,operating costs of operator1 + weeding
08/Dec/1996,1037.5170758948864,,38053.0941970824,cropprice (maize)
08/Dec/1996,83.5879794034091,,38136.68217648581,cropprice (maize_residue)
08/Dec/1996,,0.75,38135.93217648581,operating costs of operator1 + harvesting
29/Dec/1996,0.0,,38135.93217648581,cropprice (maize)
29/Dec/1996,8.184724982954545,,38144.11690146876,cropprice (maize_residue)
29/Dec/1996,,0.25,38143.86690146876,operating costs of operator1 + harvesting
17/Jan/1997,,0.75,38143.11690146876,operating costs of operator1 + weeding
07/Feb/1997,,0.25,38142.86690146876,operating costs of operator1 + weeding
27/Mar/1997,,31.5,38111.36690146876,sowing costs
27/Mar/1997,,10.5,38100.86690146876,sowing costs
27/Mar/1997,,0.75,38100.11690146876,operating costs of operator1 + presow_till
28/Mar/1997,,0.75,38099.36690146876,operating costs of operator1 + sowing
29/Mar/1997,,0.25,38099.11690146876,operating costs of operator1 + presow_till
30/Mar/1997,,0.25,38098.86690146876,operating costs of operator1 + sowing
26/Apr/1997,,0.75,38098.11690146876,operating costs of operator1 + weeding
27/Apr/1997,,0.25,38097.86690146876,operating costs of operator1 + weeding
30/Jun/1997,,606.1,37491.76690146876,Farm Overheads
06/Jul/1997,884.1104112272726,,38375.87731269604,cropprice (bean)
06/Jul/1997,978.4979452201703,,39354.37525791621,cropprice (maize)
06/Jul/1997,146.21852249999998,,39500.59378041621,cropprice (maize_residue)
06/Jul/1997,,0.75,39499.84378041621,operating costs of operator1 + harvesting
07/Jul/1997,,0.75,39499.09378041621,operating costs of operator1 + harvesting
13/Jul/1997,0.0,,39499.09378041621,cropprice (maize)
13/Jul/1997,15.195559414772731,,39514.28933983098,cropprice (maize_residue)
13/Jul/1997,,0.25,39514.03933983098,operating costs of operator1 + harvesting
15/Aug/1997,,0.75,39513.28933983098,operating costs of operator1 + weeding
22/Aug/1997,,0.25,39513.03933983098,operating costs of operator1 + weeding
11/Oct/1997,,15.0,39498.03933983098,sowing costs
11/Oct/1997,,5.0,39493.03933983098,sowing costs
11/Oct/1997,,0.75,39492.28933983098,operating costs of operator1 + presow_till
12/Oct/1997,,0.75,39491.53933983098,operating costs of operator1 + sowing
13/Oct/1997,,0.25,39491.28933983098,operating costs of operator1 + presow_till
14/Oct/1997,,0.25,39491.03933983098,operating costs of operator1 + sowing
10/Nov/1997,,0.75,39490.28933983098,operating costs of operator1 + weeding
11/Nov/1997,,0.25,39490.03933983098,operating costs of operator1 + weeding
19/Jan/1998,994.1352947769886,,40484.174634607974,cropprice (maize)
19/Jan/1998,79.62970525568181,,40563.80433986366,cropprice (maize_residue)
19/Jan/1998,,0.75,40563.05433986366,operating costs of operator1 + harvesting
04/Feb/1998,0.0,,40563.05433986366,cropprice (maize)
04/Feb/1998,10.787524136363638,,40573.84186400002,cropprice (maize_residue)
04/Feb/1998,,0.25,40573.59186400002,operating costs of operator1 + harvesting
28/Feb/1998,,0.75,40572.84186400002,operating costs of operator1 + weeding
16/Mar/1998,,0.25,40572.59186400002,operating costs of operator1 + weeding
26/Mar/1998,,31.5,40541.09186400002,sowing costs
26/Mar/1998,,10.5,40530.59186400002,sowing costs
26/Mar/1998,,0.75,40529.84186400002,operating costs of operator1 + presow_till
27/Mar/1998,,0.75,40529.09186400002,operating costs of operator1 + sowing
28/Mar/1998,,0.25,40528.84186400002,operating costs of operator1 + presow_till
29/Mar/1998,,0.25,40528.59186400002,operating costs of operator1 + sowing
25/Apr/1998,,0.75,40527.84186400002,operating costs of operator1 + weeding
26/Apr/1998,,0.25,40527.59186400002,operating costs of operator1 + weeding
30/Jun/1998,,606.1,39921.491864000025,Farm Overheads
03/Jul/1998,1094.3842372670454,,41015.87610126707,cropprice (bean)
03/Jul/1998,27.855554356534093,,41043.731655623604,cropprice (maize)
03/Jul/1998,181.17500444318182,,41224.90666006679,cropprice (maize_residue)
03/Jul/1998,,0.75,41224.15666006679,operating costs of operator1 + harvesting
04/Jul/1998,,0.75,41223.40666006679,operating costs of operator1 + harvesting
19/Jul/1998,0.0,,41223.40666006679,cropprice (maize)
19/Jul/1998,8.860334914772727,,41232.26699498156,cropprice (maize_residue)
19/Jul/1998,,0.25,41232.01699498156,operating costs of operator1 + harvesting
12/Aug/1998,,0.75,41231.26699498156,operating costs of operator1 + weeding
28/Aug/1998,,0.25,41231.01699498156,operating costs of operator1 + weeding
01/Sep/1998,,15.0,41216.01699498156,sowing costs
01/Sep/1998,,5.0,41211.01699498156,sowing costs
01/Sep/1998,,0.75,41210.26699498156,operating costs of operator1 + presow_till
02/Sep/1998,,0.75,41209.51699498156,operating costs of operator1 + sowing
03/Sep/1998,,0.25,41209.26699498156,operating costs of operator1 + presow_till
04/Sep/1998,,0.25,41209.01699498156,operating costs of operator1 + sowing
01/Oct/1998,,0.75,41208.26699498156,operating costs of operator1 + weeding
02/Oct/1998,,0.25,41208.01699498156,operating costs of operator1 + weeding
11/Dec/1998,807.9779325042613,,42015.99492748582,cropprice (maize)
11/Dec/1998,55.61734563068182,,42071.6122731165,cropprice (maize_residue)
11/Dec/1998,,0.75,42070.8622731165,operating costs of operator1 + harvesting
28/Dec/1998,0.0,,42070.8622731165,cropprice (maize)
28/Dec/1998,10.233510795454546,,42081.09578391196,cropprice (maize_residue)
28/Dec/1998,,0.25,42080.84578391196,operating costs of operator1 + harvesting
20/Jan/1999,,0.75,42080.09578391196,operating costs of operator1 + weeding
06/Feb/1999,,0.25,42079.84578391196,operating costs of operator1 + weeding
15/Mar/1999,,31.5,42048.34578391196,sowing costs
15/Mar/1999,,10.5,42037.84578391196,sowing costs
15/Mar/1999,,0.75,42037.09578391196,operating costs of operator1 + presow_till
16/Mar/1999,,0.75,42036.34578391196,operating costs of operator1 + sowing
17/Mar/1999,,0.25,42036.09578391196,operating costs of operator1 + presow_till
18/Mar/1999,,0.25,42035.84578391196,operating costs of operator1 + sowing
14/Apr/1999,,0.75,42035.09578391196,operating costs of operator1 + weeding
15/Apr/1999,,0.25,42034.84578391196,operating costs of operator1 + weeding
24/Jun/1999,998.5661151136362,,43033.411899025596,cropprice (bean)
24/Jun/1999,752.2250104048295,,43785.636909430425,cropprice (maize)
24/Jun/1999,150.85375421590908,,43936.490663646335,cropprice (maize_residue)
24/Jun/1999,,0.75,43935.740663646335,operating costs of operator1 + harvesting
25/Jun/1999,,0.75,43934.990663646335,operating costs of operator1 + harvesting
30/Jun/1999,,606.1,43328.890663646336,Farm Overheads
10/Jul/1999,0.0,,43328.890663646336,cropprice (maize)
10/Jul/1999,12.042633056818183,,43340.93329670315,cropprice (maize_residue)
10/Jul/1999,,0.25,43340.68329670315,operating costs of operator1 + harvesting
03/Aug/1999,,0.75,43339.93329670315,operating costs of operator1 + weeding
19/Aug/1999,,0.25,43339.68329670315,operating costs of operator1 + weeding
01/Sep/1999,,15.0,43324.68329670315,sowing costs
01/Sep/1999,,5.0,43319.68329670315,sowing costs
01/Sep/1999,,0.75,43318.93329670315,operating costs of operator1 + presow_till
02/Sep/1999,,0.75,43318.18329670315,operating costs of operator1 + sowing
03/Sep/1999,,0.25,43317.93329670315,operating costs of operator1 + presow_till
04/Sep/1999,,0.25,43317.68329670315,operating costs of operator1 + sowing
01/Oct/1999,,0.75,43316.93329670315,operating costs of operator1 + weeding
02/Oct/1999,,0.25,43316.68329670315,operating costs of operator1 + weeding
12/Dec/1999,1009.7889437428977,,44326.47224044605,cropprice (maize)
12/Dec/1999,78.13901867045453,,44404.6112591165,cropprice (maize_residue)
12/Dec/1999,,0.75,44403.8612591165,operating costs of operator1 + harvesting
02/Jan/2000,0.0,,44403.8612591165,cropprice (maize)
02/Jan/2000,7.865091500000001,,44411.7263506165,cropprice (maize_residue)
02/Jan/2000,,0.25,44411.4763506165,operating costs of operator1 + harvesting
21/Jan/2000,,0.75,44410.7263506165,operating costs of operator1 + weeding
11/Feb/2000,,0.25,44410.4763506165,operating costs of operator1 + weeding
19/Mar/2000,,31.5,44378.9763506165,sowing costs
19/Mar/2000,,10.5,44368.4763506165,sowing costs
19/Mar/2000,,0.75,44367.7263506165,operating costs of operator1 + presow_till
20/Mar/2000,,0.75,44366.9763506165,operating costs of operator1 + sowing
21/Mar/2000,,0.25,44366.7263506165,operating costs of operator1 + presow_till
22/Mar/2000,,0.25,44366.4763506165,operating costs of operator1 + sowing
18/Apr/2000,,0.75,44365.7263506165,operating costs of operator1 + weeding
19/Apr/2000,,0.25,44365.4763506165,operating costs of operator1 + weeding
23/Jun/2000,255.7661256818182,,44621.24247629832,cropprice (bean)
23/Jun/2000,944.9277632386363,,45566.17023953696,cropprice (maize)
23/Jun/2000,98.03180486931818,,45664.20204440627,cropprice (maize_residue)
23/Jun/2000,,0.75,45663.45204440627,operating costs of operator1 + harvesting
24/Jun/2000,,0.75,45662.70204440627,operating costs of operator1 + harvesting
29/Jun/2000,,606.1,45056.602044406274,Farm Overheads
01/Jul/2000,0.0,,45056.602044406274,cropprice (maize)
01/Jul/2000,16.479049681818182,,45073.08109408809,cropprice (maize_residue)
01/Jul/2000,,0.25,45072.83109408809,operating costs of operator1 + harvesting
02/Aug/2000,,0.75,45072.08109408809,operating costs of operator1 + weeding
10/Aug/2000,,0.25,45071.83109408809,operating costs of operator1 + weeding
30/Aug/2000,,15.0,45056.83109408809,sowing costs
30/Aug/2000,,5.0,45051.83109408809,sowing costs
30/Aug/2000,,0.75,45051.08109408809,operating costs of operator1 + presow_till
31/Aug/2000,,0.75,45050.33109408809,operating costs of operator1 + sowing
01/Sep/2000,,0.25,45050.08109408809,operating costs of operator1 + presow_till
02/Sep/2000,,0.25,45049.83109408809,operating costs of operator1 + sowing
29/Sep/2000,,0.75,45049.08109408809,operating costs of operator1 + weeding
30/Sep/2000,,0.25,45048.83109408809,operating costs of operator1 + weeding
08/Dec/2000,697.2684255894885,,45746.09951967758,cropprice (maize)
08/Dec/2000,49.368655125,,45795.468174802576,cropprice (maize_residue)
08/Dec/2000,,0.75,45794.718174802576,operating costs of operator1 + harvesting
30/Dec/2000,0.0,,45794.718174802576,cropprice (maize)
30/Dec/2000,6.803085329545454,,45801.52126013212,cropprice (maize_residue)
30/Dec/2000,,0.25,45801.27126013212,operating costs of operator1 + harvesting
17/Jan/2001,,0.75,45800.52126013212,operating costs of operator1 + weeding
08/Feb/2001,,0.25,45800.27126013212,operating costs of operator1 + weeding
15/Mar/2001,,31.5,45768.77126013212,sowing costs
15/Mar/2001,,10.5,45758.27126013212,sowing costs
15/Mar/2001,,0.75,45757.52126013212,operating costs of operator1 + presow_till
16/Mar/2001,,0.75,45756.77126013212,operating costs of operator1 + sowing
17/Mar/2001,,0.25,45756.52126013212,operating costs of operator1 + presow_till
18/Mar/2001,,0.25,45756.27126013212,operating costs of operator1 + sowing
14/Apr/2001,,0.75,45755.52126013212,operating costs of operator1 + weeding
15/Apr/2001,,0.25,45755.27126013212,operating costs of operator1 + weeding
23/Jun/2001,1382.0256210170455,,47137.29688114917,cropprice (bean)
23/Jun/2001,330.80737134375,,47468.104252492914,cropprice (maize)
23/Jun/2001,190.0474298693182,,47658.15168236223,cropprice (maize_residue)
23/Jun/2001,,0.75,47657.40168236223,operating costs of operator1 + harvesting
24/Jun/2001,,0.75,47656.65168236223,operating costs of operator1 + harvesting
30/Jun/2001,,606.1,47050.55168236223,Farm Overheads
06/Jul/2001,0.0,,47050.55168236223,cropprice (maize)
06/Jul/2001,11.467473119318184,,47062.01915548155,cropprice (maize_residue)
06/Jul/2001,,0.25,47061.76915548155,operating costs of operator1 + harvesting
02/Aug/2001,,0.75,47061.01915548155,operating costs of operator1 + weeding
15/Aug/2001,,0.25,47060.76915548155,operating costs of operator1 + weeding
01/Sep/2001,,15.0,47045.76915548155,sowing costs
01/Sep/2001,,5.0,47040.76915548155,sowing costs
01/Sep/2001,,0.75,47040.01915548155,operating costs of operator1 + presow_till
02/Sep/2001,,0.75,47039.26915548155,operating costs of operator1 + sowing
03/Sep/2001,,0.25,47039.01915548155,operating costs of operator1 + presow_till
04/Sep/2001,,0.25,47038.76915548155,operating costs of operator1 + sowing
01/Oct/2001,,0.75,47038.01915548155,operating costs of operator1 + weeding
02/Oct/2001,,0.25,47037.76915548155,operating costs of operator1 + weeding
08/Dec/2001,1040.1831733295455,,48077.952328811094,cropprice (maize)
08/Dec/2001,77.66073886363635,,48155.61306767473,cropprice (maize_residue)
08/Dec/2001,,0.75,48154.86306767473,operating costs of operator1 + harvesting
28/Dec/2001,0.0,,48154.86306767473,cropprice (maize)
28/Dec/2001,7.512053056818181,,48162.37512073154,cropprice (maize_residue)
28/Dec/2001,,0.25,48162.12512073154,operating costs of operator1 + harvesting
17/Jan/2002,,0.75,48161.37512073154,operating costs of operator1 + weeding
06/Feb/2002,,0.25,48161.12512073154,operating costs of operator1 + weeding
15/Mar/2002,,31.5,48129.62512073154,sowing costs
15/Mar/2002,,10.5,48119.12512073154,sowing costs
15/Mar/2002,,0.75,48118.37512073154,operating costs of operator1 + presow_till
16/Mar/2002,,0.75,48117.62512073154,operating costs of operator1 + sowing
17/Mar/2002,,0.25,48117.37512073154,operating costs of operator1 + presow_till
18/Mar/2002,,0.25,48117.12512073154,operating costs of operator1 + sowing
14/Apr/2002,,0.75,48116.37512073154,operating costs of operator1 + weeding
15/Apr/2002,,0.25,48116.12512073154,operating costs of operator1 + weeding
19/Jun/2002,793.8461775681817,,48909.97129829972,cropprice (bean)
19/Jun/2002,699.5198346647728,,49609.4911329645,cropprice (maize)
19/Jun/2002,141.4379882897727,,49750.92912125427,cropprice (maize_residue)
19/Jun/2002,,0.75,49750.17912125427,operating costs of operator1 + harvesting
20/Jun/2002,,0.75,49749.42912125427,operating costs of operator1 + harvesting
29/Jun/2002,0.0,,49749.42912125427,cropprice (maize)
29/Jun/2002,12.872965034090909,,49762.30208628836,cropprice (maize_residue)
29/Jun/2002,,0.25,49762.05208628836,operating costs of operator1 + harvesting
30/Jun/2002,,606.1,49155.95208628836,Farm Overheads
29/Jul/2002,,0.75,49155.20208628836,operating costs of operator1 + weeding
08/Aug/2002,,0.25,49154.95208628836,operating costs of operator1 + weeding
03/Sep/2002,,15.0,49139.95208628836,sowing costs
03/Sep/2002,,5.0,49134.95208628836,sowing costs
03/Sep/2002,,0.75,49134.20208628836,operating costs of operator1 + presow_till
04/Sep/2002,,0.75,49133.45208628836,operating costs of operator1 + sowing
05/Sep/2002,,0.25,49133.20208628836,operating costs of operator1 + presow_till
06/Sep/2002,,0.25,49132.95208628836,operating costs of operator1 + sowing
03/Oct/2002,,0.75,49132.20208628836,operating costs of operator1 + weeding
04/Oct/2002,,0.25,49131.95208628836,operating costs of operator1 + weeding
08/Dec/2002,1032.5907857173297,,50164.54287200569,cropprice (maize)
08/Dec/2002,75.99815785227273,,50240.54102985796,cropprice (maize_residue)
08/Dec/2002,,0.75,50239.79102985796,operating costs of operator1 + harvesting
28/Dec/2002,0.0,,50239.79102985796,cropprice (maize)
28/Dec/2002,8.280696522727272,,50248.07172638069,cropprice (maize_residue)
28/Dec/2002,,0.25,50247.82172638069,operating costs of operator1 + harvesting
17/Jan/2003,,0.75,50247.07172638069,operating costs of operator1 + weeding
06/Feb/2003,,0.25,50246.82172638069,operating costs of operator1 + weeding
27/Mar/2003,,31.5,50215.32172638069,sowing costs
27/Mar/2003,,10.5,50204.82172638069,sowing costs
27/Mar/2003,,0.75,50204.07172638069,operating costs of operator1 + presow_till
28/Mar/2003,,0.75,50203.32172638069,operating costs of operator1 + sowing
29/Mar/2003,,0.25,50203.07172638069,operating costs of operator1 + presow_till
30/Mar/2003,,0.25,50202.82172638069,operating costs of operator1 + sowing
26/Apr/2003,,0.75,50202.07172638069,operating costs of operator1 + weeding
27/Apr/2003,,0.25,50201.82172638069,operating costs of operator1 + weeding
30/Jun/2003,,606.1,49595.72172638069,Farm Overheads
02/Jul/2003,272.28125781818187,,49868.00298419887,cropprice (bean)
02/Jul/2003,918.2689344076705,,50786.271918606544,cropprice (maize)
02/Jul/2003,85.20939497727272,,50871.48131358382,cropprice (maize_residue)
02/Jul/2003,,0.75,50870.73131358382,operating costs of operator1 + harvesting
03/Jul/2003,,0.75,50869.98131358382,operating costs of operator1 + harvesting
10/Jul/2003,0.0,,50869.98131358382,cropprice (maize)
10/Jul/2003,13.629802357954544,,50883.61111594177,cropprice (maize_residue)
10/Jul/2003,,0.25,50883.36111594177,operating costs of operator1 + harvesting
11/Aug/2003,,0.75,50882.61111594177,operating costs of operator1 + weeding
19/Aug/2003,,0.25,50882.36111594177,operating costs of operator1 + weeding
03/Sep/2003,,15.0,50867.36111594177,sowing costs
03/Sep/2003,,5.0,50862.36111594177,sowing costs
03/Sep/2003,,0.75,50861.61111594177,operating costs of operator1 + presow_till
04/Sep/2003,,0.75,50860.86111594177,operating costs of operator1 + sowing
05/Sep/2003,,0.25,50860.61111594177,operating costs of operator1 + presow_till
06/Sep/2003,,0.25,50860.36111594177,operating costs of operator1 + sowing
03/Oct/2003,,0.75,50859.61111594177,operating costs of operator1 + weeding
04/Oct/2003,,0.25,50859.36111594177,operating costs of operator1 + weeding
11/Dec/2003,16.49746619744318,,50875.85858213921,cropprice (maize)
11/Dec/2003,53.997386590909095,,50929.855968730124,cropprice (maize_residue)
11/Dec/2003,,0.75,50929.105968730124,operating costs of operator1 + harvesting
01/Jan/2004,0.0,,50929.105968730124,cropprice (maize)
01/Jan/2004,5.323066710227272,,50934.42903544035,cropprice (maize_residue)
01/Jan/2004,,0.25,50934.17903544035,operating costs of operator1 + harvesting
20/Jan/2004,,0.75,50933.42903544035,operating costs of operator1 + weeding
10/Feb/2004,,0.25,50933.17903544035,operating costs of operator1 + weeding
14/Mar/2004,,31.5,50901.67903544035,sowing costs
14/Mar/2004,,10.5,50891.17903544035,sowing costs
14/Mar/2004,,0.75,50890.42903544035,operating costs of operator1 + presow_till
15/Mar/2004,,0.75,50889.67903544035,operating costs of operator1 + sowing
16/Mar/2004,,0.25,50889.42903544035,operating costs of operator1 + presow_till
17/Mar/2004,,0.25,50889.17903544035,operating costs of operator1 + sowing
13/Apr/2004,,0.75,50888.42903544035,operating costs of operator1 + weeding
14/Apr/2004,,0.25,50888.17903544035,operating costs of operator1 + weeding
23/Jun/2004,0.0,,50888.17903544035,cropprice (maize)
23/Jun/2004,13.866369073863636,,50902.04540451421,cropprice (maize_residue)
23/Jun/2004,,0.25,50901.79540451421,operating costs of operator1 + harvesting
25/Jun/2004,1210.7370300852272,,52112.53243459944,cropprice (bean)
25/Jun/2004,0.0,,52112.53243459944,cropprice (maize)
25/Jun/2004,151.70950595454545,,52264.241940553984,cropprice (maize_residue)
25/Jun/2004,,0.75,52263.491940553984,operating costs of operator1 + harvesting
26/Jun/2004,,0.75,52262.741940553984,operating costs of operator1 + harvesting
29/Jun/2004,,606.1,51656.641940553985,Farm Overheads
02/Aug/2004,,0.25,51656.391940553985,operating costs of operator1 + weeding
04/Aug/2004,,0.75,51655.641940553985,operating costs of operator1 + weeding
04/Sep/2004,,15.0,51640.641940553985,sowing costs
04/Sep/2004,,5.0,51635.641940553985,sowing costs
04/Sep/2004,,0.75,51634.891940553985,operating costs of operator1 + presow_till
05/Sep/2004,,0.75,51634.141940553985,operating costs of operator1 + sowing
06/Sep/2004,,0.25,51633.891940553985,operating costs of operator1 + presow_till
07/Sep/2004,,0.25,51633.641940553985,operating costs of operator1 + sowing
04/Oct/2004,,0.75,51632.891940553985,operating costs of operator1 + weeding
05/Oct/2004,,0.25,51632.641940553985,operating costs of operator1 + weeding
10/Dec/2004,713.2693988735796,,52345.91133942756,cropprice (maize)
10/Dec/2004,47.14189286931818,,52393.05323229688,cropprice (maize_residue)
10/Dec/2004,,0.75,52392.30323229688,operating costs of operator1 + harvesting
30/Dec/2004,0.0,,52392.30323229688,cropprice (maize)
30/Dec/2004,6.9036823636363644,,52399.20691466051,cropprice (maize_residue)
30/Dec/2004,,0.25,52398.95691466051,operating costs of operator1 + harvesting
19/Jan/2005,,0.75,52398.20691466051,operating costs of operator1 + weeding
08/Feb/2005,,0.25,52397.95691466051,operating costs of operator1 + weeding
22/Mar/2005,,31.5,52366.45691466051,sowing costs
22/Mar/2005,,10.5,52355.95691466051,sowing costs
22/Mar/2005,,0.75,52355.20691466051,operating costs of operator1 + presow_till
23/Mar/2005,,0.75,52354.45691466051,operating costs of operator1 + sowing
24/Mar/2005,,0.25,52354.20691466051,operating costs of operator1 + presow_till
25/Mar/2005,,0.25,52353.95691466051,operating costs of operator1 + sowing
21/Apr/2005,,0.75,52353.20691466051,operating costs of operator1 + weeding
22/Apr/2005,,0.25,52352.95691466051,operating costs of operator1 + weeding
25/Jun/2005,273.70798552840915,,52626.664900188924,cropprice (bean)
25/Jun/2005,950.6822605823863,,53577.34716077131,cropprice (maize)
25/Jun/2005,90.86753706818182,,53668.21469783949,cropprice (maize_residue)
25/Jun/2005,,0.75,53667.46469783949,operating costs of operator1 + harvesting
26/Jun/2005,,0.75,53666.71469783949,operating costs of operator1 + harvesting
30/Jun/2005,,606.1,53060.61469783949,Farm Overheads
03/Jul/2005,0.0,,53060.61469783949,cropprice (maize)
03/Jul/2005,13.399644329545454,,53074.01434216904,cropprice (maize_residue)
03/Jul/2005,,0.25,53073.76434216904,operating costs of operator1 + harvesting
04/Aug/2005,,0.75,53073.01434216904,operating costs of operator1 + weeding
12/Aug/2005,,0.25,53072.76434216904,operating costs of operator1 + weeding
01/Sep/2005,,15.0,53057.76434216904,sowing costs
01/Sep/2005,,5.0,53052.76434216904,sowing costs
01/Sep/2005,,0.75,53052.01434216904,operating costs of operator1 + presow_till
02/Sep/2005,,0.75,53051.26434216904,operating costs of operator1 + sowing
03/Sep/2005,,0.25,53051.01434216904,operating costs of operator1 + presow_till
04/Sep/2005,,0.25,53050.76434216904,operating costs of operator1 + sowing
01/Oct/2005,,0.75,53050.01434216904,operating costs of operator1 + weeding
02/Oct/2005,,0.25,53049.76434216904,operating costs of operator1 + weeding
09/Dec/2005,0.0,,53049.76434216904,cropprice (maize)
09/Dec/2005,54.53530883522726,,53104.299651004265,cropprice (maize_residue)
09/Dec/2005,,0.75,53103.549651004265,operating costs of operator1 + harvesting
27/Dec/2005,0.0,,53103.549651004265,cropprice (maize)
27/Dec/2005,4.558049289772727,,53108.10770029404,cropprice (maize_residue)
27/Dec/2005,,0.25,53107.85770029404,operating costs of operator1 + harvesting
18/Jan/2006,,0.75,53107.10770029404,operating costs of operator1 + weeding
05/Feb/2006,,0.25,53106.85770029404,operating costs of operator1 + weeding
19/Mar/2006,,31.5,53075.35770029404,sowing costs
19/Mar/2006,,10.5,53064.85770029404,sowing costs
19/Mar/2006,,0.75,53064.10770029404,operating costs of operator1 + presow_till
20/Mar/2006,,0.75,53063.35770029404,operating costs of operator1 + sowing
21/Mar/2006,,0.25,53063.10770029404,operating costs of operator1 + presow_till
22/Mar/2006,,0.25,53062.85770029404,operating costs of operator1 + sowing
18/Apr/2006,,0.75,53062.10770029404,operating costs of operator1 + weeding
19/Apr/2006,,0.25,53061.85770029404,operating costs of operator1 + weeding
30/Jun/2006,,606.1,52455.75770029404,Farm Overheads
11/Jul/2006,2140.3909524375,,54596.148652731536,cropprice (bean)
11/Jul/2006,0.0,,54596.148652731536,cropprice (maize)
11/Jul/2006,138.82260964772723,,54734.971262379266,cropprice (maize_residue)
11/Jul/2006,0.0,,54734.971262379266,cropprice (maize)
11/Jul/2006,10.617717397727272,,54745.58897977699,cropprice (maize_residue)
11/Jul/2006,,0.75,54744.83897977699,operating costs of operator1 + harvesting
12/Jul/2006,,0.75,54744.08897977699,operating costs of operator1 + harvesting
13/Jul/2006,,0.25,54743.83897977699,operating costs of operator1 + harvesting
20/Aug/2006,,0.75,54743.08897977699,operating costs of operator1 + weeding
21/Aug/2006,,0.25,54742.83897977699,operating costs of operator1 + weeding
01/Sep/2006,,15.0,54727.83897977699,sowing costs
01/Sep/2006,,5.0,54722.83897977699,sowing costs
01/Sep/2006,,0.75,54722.08897977699,operating costs of operator1 + presow_till
02/Sep/2006,,0.75,54721.33897977699,operating costs of operator1 + sowing
03/Sep/2006,,0.25,54721.08897977699,operating costs of operator1 + presow_till
04/Sep/2006,,0.25,54720.83897977699,operating costs of operator1 + sowing
01/Oct/2006,,0.75,54720.08897977699,operating costs of operator1 + weeding
02/Oct/2006,,0.25,54719.83897977699,operating costs of operator1 + weeding
08/Dec/2006,960.9274532940342,,55680.766433071025,cropprice (maize)
08/Dec/2006,58.85106311931819,,55739.617496190345,cropprice (maize_residue)
08/Dec/2006,,0.75,55738.867496190345,operating costs of operator1 + harvesting
31/Dec/2006,0.0,,55738.867496190345,cropprice (maize)
31/Dec/2006,7.341382113636364,,55746.20887830398,cropprice (maize_residue)
31/Dec/2006,,0.25,55745.95887830398,operating costs of operator1 + harvesting
17/Jan/2007,,0.75,55745.20887830398,operating costs of operator1 + weeding
09/Feb/2007,,0.25,55744.95887830398,operating costs of operator1 + weeding
18/Mar/2007,,31.5,55713.45887830398,sowing costs
18/Mar/2007,,10.5,55702.95887830398,sowing costs
18/Mar/2007,,0.75,55702.20887830398,operating costs of operator1 + presow_till
19/Mar/2007,,0.75,55701.45887830398,operating costs of operator1 + sowing
20/Mar/2007,,0.25,55701.20887830398,operating costs of operator1 + presow_till
21/Mar/2007,,0.25,55700.95887830398,operating costs of operator1 + sowing
17/Apr/2007,,0.75,55700.20887830398,operating costs of operator1 + weeding
18/Apr/2007,,0.25,55699.95887830398,operating costs of operator1 + weeding
21/Jun/2007,265.34861969318183,,55965.307497997164,cropprice (bean)
21/Jun/2007,980.1349597968751,,56945.44245779404,cropprice (maize)
21/Jun/2007,100.42513482954544,,57045.86759262358,cropprice (maize_residue)
21/Jun/2007,,0.75,57045.11759262358,operating costs of operator1 + harvesting
22/Jun/2007,,0.75,57044.36759262358,operating costs of operator1 + harvesting
30/Jun/2007,,606.1,56438.26759262358,Farm Overheads
08/Jul/2007,0.0,,56438.26759262358,cropprice (maize)
08/Jul/2007,10.87451865340909,,56449.14211127699,cropprice (maize_residue)
08/Jul/2007,,0.25,56448.89211127699,operating costs of operator1 + harvesting
31/Jul/2007,,0.75,56448.14211127699,operating costs of operator1 + weeding
17/Aug/2007,,0.25,56447.89211127699,operating costs of operator1 + weeding
01/Sep/2007,,15.0,56432.89211127699,sowing costs
01/Sep/2007,,5.0,56427.89211127699,sowing costs
01/Sep/2007,,0.75,56427.14211127699,operating costs of operator1 + presow_till
02/Sep/2007,,0.75,56426.39211127699,operating costs of operator1 + sowing
03/Sep/2007,,0.25,56426.14211127699,operating costs of operator1 + presow_till
04/Sep/2007,,0.25,56425.89211127699,operating costs of operator1 + sowing
01/Oct/2007,,0.75,56425.14211127699,operating costs of operator1 + weeding
02/Oct/2007,,0.25,56424.89211127699,operating costs of operator1 + weeding
10/Dec/2007,390.7333249772727,,56815.62543625426,cropprice (maize)
10/Dec/2007,52.74957692045455,,56868.375013174715,cropprice (maize_residue)
10/Dec/2007,,0.75,56867.625013174715,operating costs of operator1 + harvesting
03/Jan/2008,0.0,,56867.625013174715,cropprice (maize)
03/Jan/2008,6.299104170454544,,56873.92411734517,cropprice (maize_residue)
03/Jan/2008,,0.25,56873.67411734517,operating costs of operator1 + harvesting
19/Jan/2008,,0.75,56872.92411734517,operating costs of operator1 + weeding
12/Feb/2008,,0.25,56872.67411734517,operating costs of operator1 + weeding
17/Mar/2008,,31.5,56841.17411734517,sowing costs
17/Mar/2008,,10.5,56830.67411734517,sowing costs
17/Mar/2008,,0.75,56829.92411734517,operating costs of operator1 + presow_till
18/Mar/2008,,0.75,56829.17411734517,operating costs of operator1 + sowing
19/Mar/2008,,0.25,56828.92411734517,operating costs of operator1 + presow_till
20/Mar/2008,,0.25,56828.67411734517,operating costs of operator1 + sowing
16/Apr/2008,,0.75,56827.92411734517,operating costs of operator1 + weeding
17/Apr/2008,,0.25,56827.67411734517,operating costs of operator1 + weeding
24/Jun/2008,1143.5380553863638,,57971.21217273153,cropprice (bean)
24/Jun/2008,610.4076241065341,,58581.619796838066,cropprice (maize)
24/Jun/2008,171.15668834659093,,58752.77648518466,cropprice (maize_residue)
24/Jun/2008,,0.75,58752.02648518466,operating costs of operator1 + harvesting
25/Jun/2008,,0.75,58751.27648518466,operating costs of operator1 + harvesting
29/Jun/2008,,606.1,58145.17648518466,Farm Overheads
05/Jul/2008,0.0,,58145.17648518466,cropprice (maize)
05/Jul/2008,12.834783380681818,,58158.011268565344,cropprice (maize_residue)
05/Jul/2008,,0.25,58157.761268565344,operating costs of operator1 + harvesting
03/Aug/2008,,0.75,58157.011268565344,operating costs of operator1 + weeding
14/Aug/2008,,0.25,58156.761268565344,operating costs of operator1 + weeding
30/Aug/2008,,15.0,58141.761268565344,sowing costs
30/Aug/2008,,5.0,58136.761268565344,sowing costs
30/Aug/2008,,0.75,58136.011268565344,operating costs of operator1 + presow_till
31/Aug/2008,,0.75,58135.261268565344,operating costs of operator1 + sowing
01/Sep/2008,,0.25,58135.011268565344,operating costs of operator1 + presow_till
02/Sep/2008,,0.25,58134.761268565344,operating costs of operator1 + sowing
29/Sep/2008,,0.75,58134.011268565344,operating costs of operator1 + weeding
30/Sep/2008,,0.25,58133.761268565344,operating costs of operator1 + weeding
06/Dec/2008,981.8515442684659,,59115.61281283381,cropprice (maize)
06/Dec/2008,66.02802346022727,,59181.640836294035,cropprice (maize_residue)
06/Dec/2008,,0.75,59180.890836294035,operating costs of operator1 + harvesting
29/Dec/2008,0.0,,59180.890836294035,cropprice (maize)
29/Dec/2008,5.874222494318182,,59186.765058788355,cropprice (maize_residue)
29/Dec/2008,,0.25,59186.515058788355,operating costs of operator1 + harvesting
15/Jan/2009,,0.75,59185.765058788355,operating costs of operator1 + weeding
07/Feb/2009,,0.25,59185.515058788355,operating costs of operator1 + weeding
18/Mar/2009,,31.5,59154.015058788355,sowing costs
18/Mar/2009,,10.5,59143.515058788355,sowing costs
18/Mar/2009,,0.75,59142.765058788355,operating costs of operator1 + presow_till
19/Mar/2009,,0.75,59142.015058788355,operating costs of operator1 + sowing
20/Mar/2009,,0.25,59141.765058788355,operating costs of operator1 + presow_till
21/Mar/2009,,0.25,59141.515058788355,operating costs of operator1 + sowing
17/Apr/2009,,0.75,59140.765058788355,operating costs of operator1 + weeding
18/Apr/2009,,0.25,59140.515058788355,operating costs of operator1 + weeding
20/Jun/2009,207.9261256704545,,59348.44118445881,cropprice (bean)
20/Jun/2009,1016.6831296107956,,60365.1243140696,cropprice (maize)
20/Jun/2009,96.50224997727273,,60461.62656404688,cropprice (maize_residue)
20/Jun/2009,,0.75,60460.87656404688,operating costs of operator1 + harvesting
21/Jun/2009,,0.75,60460.12656404688,operating costs of operator1 + harvesting
30/Jun/2009,0.0,,60460.12656404688,cropprice (maize)
30/Jun/2009,12.964374886363636,,60473.09093893324,cropprice (maize_residue)
30/Jun/2009,,0.25,60472.84093893324,operating costs of operator1 + harvesting
30/Jun/2009,,606.1,59866.74093893324,Farm Overheads
30/Jul/2009,,0.75,59865.99093893324,operating costs of operator1 + weeding
09/Aug/2009,,0.25,59865.74093893324,operating costs of operator1 + weeding
01/Sep/2009,,15.0,59850.74093893324,sowing costs
01/Sep/2009,,5.0,59845.74093893324,sowing costs
01/Sep/2009,,0.75,59844.99093893324,operating costs of operator1 + presow_till
02/Sep/2009,,0.75,59844.24093893324,operating costs of operator1 + sowing
03/Sep/2009,,0.25,59843.99093893324,operating costs of operator1 + presow_till
04/Sep/2009,,0.25,59843.74093893324,operating costs of operator1 + sowing
01/Oct/2009,,0.75,59842.99093893324,operating costs of operator1 + weeding
02/Oct/2009,,0.25,59842.74093893324,operating costs of operator1 + weeding
09/Dec/2009,279.36866556818177,,60122.10960450142,cropprice (maize)
09/Dec/2009,54.27578180113637,,60176.38538630256,cropprice (maize_residue)
09/Dec/2009,,0.75,60175.63538630256,operating costs of operator1 + harvesting
29/Dec/2009,0.0,,60175.63538630256,cropprice (maize)
29/Dec/2009,5.9213874147727275,,60181.55677371733,cropprice (maize_residue)
29/Dec/2009,,0.25,60181.30677371733,operating costs of operator1 + harvesting
18/Jan/2010,,0.75,60180.55677371733,operating costs of operator1 + weeding
07/Feb/2010,,0.25,60180.30677371733,operating costs of operator1 + weeding
18/Mar/2010,,31.5,60148.80677371733,sowing costs
18/Mar/2010,,10.5,60138.30677371733,sowing costs
18/Mar/2010,,0.75,60137.55677371733,operating costs of operator1 + presow_till
19/Mar/2010,,0.75,60136.80677371733,operating costs of operator1 + sowing
20/Mar/2010,,0.25,60136.55677371733,operating costs of operator1 + presow_till
21/Mar/2010,,0.25,60136.30677371733,operating costs of operator1 + sowing
17/Apr/2010,,0.75,60135.55677371733,operating costs of operator1 + weeding
18/Apr/2010,,0.25,60135.30677371733,operating costs of operator1 + weeding
20/Jun/2010,282.0207940056818,,60417.32756772301,cropprice (bean)
20/Jun/2010,698.5613092244319,,61115.88887694744,cropprice (maize)
20/Jun/2010,87.52294922727272,,61203.41182617471,cropprice (maize_residue)
20/Jun/2010,,0.75,61202.66182617471,operating costs of operator1 + harvesting
21/Jun/2010,,0.75,61201.91182617471,operating costs of operator1 + harvesting
30/Jun/2010,,606.1,60595.811826174715,Farm Overheads
01/Jul/2010,0.0,,60595.811826174715,cropprice (maize)
01/Jul/2010,12.331989636363636,,60608.143815811076,cropprice (maize_residue)
01/Jul/2010,,0.25,60607.893815811076,operating costs of operator1 + harvesting
30/Jul/2010,,0.75,60607.143815811076,operating costs of operator1 + weeding
10/Aug/2010,,0.25,60606.893815811076,operating costs of operator1 + weeding
01/Sep/2010,,15.0,60591.893815811076,sowing costs
01/Sep/2010,,5.0,60586.893815811076,sowing costs
01/Sep/2010,,0.75,60586.143815811076,operating costs of operator1 + presow_till
02/Sep/2010,,0.75,60585.393815811076,operating costs of operator1 + sowing
03/Sep/2010,,0.25,60585.143815811076,operating costs of operator1 + presow_till
04/Sep/2010,,0.25,60584.893815811076,operating costs of operator1 + sowing
01/Oct/2010,,0.75,60584.143815811076,operating costs of operator1 + weeding
02/Oct/2010,,0.25,60583.893815811076,operating costs of operator1 + weeding
09/Dec/2010,209.3996383082386,,60793.29345411932,cropprice (maize)
09/Dec/2010,57.81345436363636,,60851.10690848295,cropprice (maize_residue)
09/Dec/2010,,0.75,60850.35690848295,operating costs of operator1 + harvesting
27/Dec/2010,0.0,,60850.35690848295,cropprice (maize)
27/Dec/2010,6.426488704545456,,60856.78339718749,cropprice (maize_residue)
27/Dec/2010,,0.25,60856.53339718749,operating costs of operator1 + harvesting
